HTTP/1.1 200 OK
Connection: close
Transfer-Encoding: chunked
Access-Control-Allow-Credentials: true
Access-Control-Allow-Origin: *
Access-Control-Expose-Headers: Link,X-RateLimit-Reset,X-RateLimit-Limit,X-RateLimit-Remaining,X-Request-Id,Idempotency-Key
Cache-Control: no-cache
Cdn-Cache: MISS
Cdn-Cachedat: 11/09/2022 14:56:58
Cdn-Edgestorageid: 883
Cdn-Proxyver: 1.03
Cdn-Pullzone: 1014260
Cdn-Requestcountrycode: BE
Cdn-Requestid: 70999f341de1a9391b72dcfa63f3f84f
Cdn-Requestpullcode: 200
Cdn-Requestpullsuccess: True
Cdn-Status: 200
Cdn-Uid: fdb9b876-568b-4033-8999-074fb1dd1239
Content-Security-Policy: upgrade-insecure-requests;script-src 'self';connect-src 'self' blob: https://akkoma.catgirlin.space wss://akkoma.catgirlin.space;media-src 'self' https:;img-src 'self' data: blob: https:;default-src 'none';base-uri 'self';frame-ancestors 'none';style-src 'self' 'unsafe-inline';font-src 'self';manifest-src 'self';
Content-Type: application/json; charset=utf-8
Date: Wed, 09 Nov 2022 14:56:58 GMT
Permissions-Policy: interest-cohort=()
Referrer-Policy: same-origin
Server: BunnyCDN-AMS-883
Vary: Accept-Encoding
X-Content-Type-Options: nosniff
X-Download-Options: noopen
X-Frame-Options: DENY
X-Permitted-Cross-Domain-Policies: none
X-Request-Id: FyXydGCWbHq6ghEAAFbh
X-Xss-Protection: 1; mode=block

6839
["friendica.a-zwenkau.de","social.kithop.ca","social.wien.rocks","svariyar.com","misskey.hw2k.com","space.rick.gr","moarrensis.org","tabletop.vip","agora.echelon.pl","freespeechextremist.com","glasgow.social","xarxa.cloud","free.burningpixel.net","mastodon.arch-linux.cz","cantos.social","art1sec.uber.space","masto.rocks","mastodon.no2nd.earth","ist.social","friendica.jb-net.us","pl.nulled.red","beefyboys.win","novoa.nagoya","fukeaka.ink","mst3k.interlinked.me","awscommunity.social","mastodon.grin.hu","h1v3.de","social.fbxl.net","minidisc.tokyo","mastodon.partecipa.digital","gruene.social","social.tchncs.de","p.node.pk","friendica.mifritscher.de","friendica.myportal.social","elekk.xyz","fedi.lynnesbian.space","lor.sh","r3pek.org","petrous.vislae.town","stereophonic.space","toot.phseiff.com","meow.lgbt","vis.social","slime.global","transgression.cafe","sciences.social","mastodon.partipirate.org","ipv6.social","sunbeam.city","plush.city","law.builders","ttrpg-hangout.social","social.mezzo.moe","eden.one","mastodon.quantumindigo.org","nicfab.it","ludosphere.fr","lily.network","djsumdog.com","sua.anarkis.net","myopic.one","plemora.undarkpixel.com","mastodon.astrr.ru","byteshift.io","www.librepunk.club","fediverse.xavin.net","masthead.social","dragon.style","morale.ch","henshaw.social","mastodon.nzoss.nz","borg.social","toot.jeena.net","seafoam.space","letsalllovela.in","camp.smolnet.org","bne.social","mastodon.hypnoguys.com","friends.grishka.me","cosmos.social","eeeeeeeee.eu","mastodon.art","social.fellr.net","your.sensor.community","mastodon.balamb.fr","shigusegubu.club","rigcz.club","iddqd.social","ioc.exchange","oc.todon.fr","mastodon.design","nitecrew.rip","social.audiovalentine.com","social.floofyplasma.com","mastodon.underworld.fr","space.jeroenvd.nl","sueden.social","fedi.vern.cc","coop.lol","nyaaa.jeder.pl","social.jesuislibre.net","art-software.fr","noagendasocial.com","irrelephant.co","fedi.lesbianforest.club","activism.openworlds.info","berlin.social","abolish.social","rebelsocial.media","screenwriting.space","himk.am","mstdn.progressiv.dev","josh.tel","fog.highspirits.games","meow.social","technodon.social","mastodon.opencloud.lu","miniwa.moe","mastodon.ericlathrop.com","plasmatrap.com","federate.hopto.org","poa.st","misskey.ai","status.steren.fr","socl.bz","maly.io","social.afront.org","social.targaryen.house","social.michaelbrooks.co.uk","0x3c.pl","awoo.chown.me","mastodon.malmorrow.com","mastodon.transneptune.net","duwa.ng","embassy.social","social.eyluldogruel.com","freak.university","retr0.id","mastodon.coffee","pooper.social","social.troll.academy","literatur.social","universeodon.com","godforsaken.website","hub.netzgemeinde.eu","friendi.linuxand.beer","masto.donte.com.br","gn-tronics.dev","blahaj.social","quasselkopf.de","sociala.me","artoot.xyz","nonexiste.net","pfalz.social","bbq.snoot.com","o3o.ca","friendica.retronerd.at","social.finkhaeuser.de","mastodon.pirateparty.be","soc.luciferi.st","akkos.fritu.re","comfyboy.club","hispagatos.space","go5.dev","gly.one","social.labmonkeys.space","bsd.network","pleroma.tilde.zone","mastodon.vierkantor.com","mastodong.lol","warhammer.social","odenwald.social","mk.himbeer.me","bookwor.ms","ni.hil.ist","chirpi.de","octodon.social","toot.dragon2611.net","liberal.lgbt","cutiehaven.club","raccoon.place","ceilidh.online","amala.schwartzwelt.xyz","williamsonday.buzz","surfin.dog","m.cmx.im","sciences.re","pdx.social","herd.bovid.space","mastodon.nl","fedi.astrid.tech","functional.cafe","kif.rocks","drosophila.social","toot.kuba-orlik.name","social.transsafety.network","travel-friends.chat","coldrick.me.uk","mastodon.tekdmn.me","mastodon.acc.sunet.se","mindly.social","docviper.de","shrine.moe","mouse.photos","ricard.social","walkman.social","inherently.digital","fediscience.org","weirder.earth","mastodon.gougere.fr","social.pueseso.club","0ne.day","mastodon.opportunis.me","fnordon.de","toot.houbahouba.de","beach.city","hci.social","oceanplayground.social","fuckmu.sk","journa.host","voi.social","cloudisland.nz","soc.citizen4.eu","oslo.town","sleeping.town","pl.comfysnug.space","is.aaronbsmith.com","raxx.la","barcelona.social","tekton.network","mastodon.online","mas.ggr.me","were.social","paws.town","snug.town","straylight.expectnomore.net","chitter.xyz","social.c-r-t.tk","sideslip.social","mastodonapp.uk","pxlmo.com","chat.skiddle.id","toot.berlin","bv.umbrellix.org","smeap.com","puto.gspot.lol","ondergrond.org","mastodon.sdf.org","glaceon.social","xoxo.zone","mastodon.multimob.be","mk.nixnet.social","mastodon.obspm.fr","ryona.agency","friends.deko.cloud","pleroma.stream","social.zdx.fr","intahnet.co.uk","coales.co","twit.social","mastodon.lol","federation.ninetiesmysteri.es","bofh.social","birb.site","circus.town","social.travisshears.xyz","csdisaster.club","bonn.social","skinnyver.se","mastodon.top","social.anufrij.de","yokai.cafe","clacks.link","akko.cuddlegirls.cafe","witter.cz","mspsocial.net","social.fantorovevo.com","devin.masto.host","mastodon.fredspieler.com","braydmedia.de","truthsocial.st","toot.cat","tech.lgbt","demon.social","sigmoid.social","friendica.youhavewrites.social","pounced-on.me","mastodontech.de","toet.dnzm.nl","sitedethib.com","mastodon.world","fedi.intkos.link","outerheaven.club","woblfedi.de","cheeseburger.social","shitpisscum.mooo.com","angrytoday.com","potate.space","ooe.social","1210.nl","zov.oti.st","mastodon.cipherbliss.com","kopfkino.social","frnd.nanoscopic.de","toot.lgbt","twipped.social","tailswish.industries","sonomu.club","social.alyve.be","tuiter.rocks","humble.cafe","tyrol.social","frogmob.life","soc.schuerz.at","m6n.io","zhub.link","fedi.9til.de","follow.schmaller.de","freespeech.firedragonstudios.com","federation.p1k3.com","epsilon-ix.masto.host","f.haeder.net","mytoot.de","social.rebased.network","social.data.coop","religion.masto.host","norden.social","masto.evelynyap.com","glammr.us","data-folks.masto.host","gts.cybre.ninja","social.zwoelfdreifuenfundvierzig.net","fediverse.pl","social.logilab.org","social.deadsuperhero.com","keybored.me","freeradical.zone","fedi2.caliandroid.de","social.saarland","shivering-isles.com","esperanto.masto.host","fuckgov.org","social.davidgarywood.com","mastodon.pl","dummy.cafe","plauderkasten.space","pleroma.potatoxel.org","social.kyiv.dcomm.net.ua","thisis.mylegendary.quest","systerserver.town","livellosegreto.it","friendica.utzer.de","social.grimneko.de","mastodontti.fi","dolphin.town","mathstodon.xyz","social.ridetrans.it","scintilla.social","fedi.absturztau.be","linuxrocks.online","scoopgang.social","pgh.social","mastodon.social","meemu.org","shelter.moe","r2.do","hax0rbana.social","peer.galaxycrow.de","bungle.online","10000x.dev","mastodon.la","coletivos.org","tooter.social","mastodon.wurzelmann.at","poto.cafe","sy.nthia.dev","node9.org","masto.vy-let.software","autonomy.ninja","noc.social","mastodon.me.uk","masto.ai","lazybear.social","graz.social","mastodon.steinernebruecke.de","lesbian.solutions","sekretaerbaer.de","dan.mastohon.com","social.tar.black","wizzzard.online","cysioland.pl","kirche.social","robot.rodeo","mk.szkod.ovh","toot-lab.reclaim.technology","a.nti.social","piaille.fr","mastodon.lertsenem.com","utopioca.com","mastodonsweden.se","planet.chrisbeckstrom.com","worldkey.io","schelling.pt","fr13nd5.com","posting.lolicon.rocks","gotosocial-dev.svc.0x0a.network","disabled.social","idf.social","glitch.taks.garden","a.n0id.space","tootaloo.me","tooty.org","nwb.social","mastodon.jordanwages.com","kitty.town","im.allmendenetz.de","tbo.social","stop.voring.me","social.marud.fr","free.gluten.space","anarchydica.net","fediweij.nl","postpandemicparty.org","polonkai.eu","libranet.de","wellduck.me","flausch.social","pawoo.net","metalhead.club","f.freinetz.ch","mastodon.tetaneutral.net","masto.pt","allnutt.net","solitary.social","hearth.michci.ooo","boing.world","mastodon.potager.org","borken.social","terra.incognita.net","friendica.mnementh.co.uk","poliverso.org","social.home.ftt.gmbh","eitelh.uber.space","sfba.social","lebalkon.de","social.plux.wtf","trailblazer.social","social.bobcall.me","rubber.social","liberal.city","unextro.net","soc.kouett.net.eu.org","varishangout.net","pewtix.com","helvede.net","masto.ezhevita.dev","nrw.social","mastodon.libre-entreprise.com","cybervillains.com","anime.website","social.juke.fr","mstdn.sheehanmiles.com","netmonkey.xyz","pegelinux.top","mstdn.fr","critter.zone","dauen.name","toot.theresnotime.io","0lb.be","60228.dev","nolineage.com","zirk.us","fandom.garden","toot.thoughtworks.com","toot.wales","social.here.blue","raru.re","social.bund.de","herzbu.de","eupublic.social","netzsphaere.xyz","vulpine.club","vancity.social","epistolary.org","socel.net","myasstodon.xyz","mastodon.technology","lubar.me","mastodon.xyz","hagew.blog","bostonmusic.online","sauropods.win","equestria.social","gnusocial.net","biscuit.town","shpakovsky.ru","genomic.social","pleroma.popolon.org","superseriousbusiness.org","fed.thecyberdeck.xyz","estrogen.network","qoto.org","social.linux.pizza","pl.nudie.social","social.outsourcedmath.com","plem.sapphic.site","youdabomb.social","schykle.com","social.ei8fdb.org","social.sturtz.io","misskey.phoebeivy.dev","gulp.cafe","kvlt.zone","sciencemastodon.com","pixelfed.de","mk.shatteredpalisa.de","gamedev.lgbt","mastodon.dmgd.monster","jumanji.co","neckarwie.se","legal.social","cryptotooter.com","dobbs.town","pars.ee","mastodon.acc.umu.se","puntarella.party","occitanie.social","indiepocalypse.social","movsw.0x0.st","telescope.garden","redwombat.social","magicalmirro.red","bilb.info","giersig.net","mastodonnederland.online","toki.social","researchbuzz.masto.host","social.dropbear.xyz","paquita.masto.host","sakura-rage.net","social.cologne","blimps.xyz","social.xenofem.me","socialnotwork.net","dizl.de","misskey.social","messurrection.com","akko.anemoneya.me","c18.masto.host","bbs.kawa-kun.com","cyberfurz.social","notacult.social","notnull.click","social.gl-como.it","social.urspringer.de","detroitriotcity.com","idiomdrottning.org","birb.space","ilyamikcoder.com","mastodon.uy","charade.social","raggedfeathers.com","magnificentbeardsfan.club","a11y.info","pouet.panglossoft.fr","alcatir.com","marf.space","mastodon.ml","nixnet.social","social.trom.tf","pleroma.viridianpatriots.com","leafposter.club","subversive.zone","willnorris.com","social.digitalcastle.me","pieville.net","cawfee.club","dair-community.social","sociale.network","climatejustice.social","lunai.re","theres.life","friendica.hellquist.eu","mk.autonomy.earth","lolison.top","social.johnassel.de","mastodon.notasquirrel.dev","pleroma.smoothdream.online","halibut.com","friendica.keithhacks.cyou","offworld.fedisonic.cloud","fed.sonnenmulde.at","mstdn.io","social.coop","clubcyberia.co","masto.glorious-space.eu","km6g.us","friendica.opensocial.space","darkfriend.social","sociable.cafe","fr.readthefinemanual.net","mastodon.joinhaven.us","lainchan.gay","toot.fedilab.app","social.shadowkat.net","mastodon.oeru.org","mastodon.internet-czas-dzialac.pl","poly.cybre.city","wrestle.town","misskey.cats-home.net","glauca.space","fromm.social","433.world","fimidi.com","c.im","ifwo.eu","witches.live","toon.social","pleroma.nylarea.com","imaginair.es","social.clallam.lgbt","mk.starnix.network","antabaka.me","juju.house","meinungsschubla.de","mastodon.nz","toots.cc","transmom.love","layer8.space","honey.town","pleroma.nobodyhasthe.biz","social.sp-codes.de","pl.kotobank.ch","social.tulsa.ok.us","geiger.ee","toot.cafe","kafka.icu","suma-ev.social","venera.social","mastodon-belgium.be","merovingian.club","indieweb.social","masto.pablofernandez.tech","mimimi01.masto.host","masto.sweetpastel.space","mas.glowing.surf","racem.us","orctavern.pub","rdrama.cc","medibubble.org","mastodon.parleur.net","social.stale.link","zeroes.ca","cathode.church","blog.serverok.pl","social.badabam.net","ausglam.space","cloud.karagory.com","bnnuy.space","hsnl.social","curiouscabbit.social","mastodont.cat","helvetica.fm","glitterkitten.co.uk","mastodon.bloonface.com","mas.atmx.ca","yuustan.space","toot.aquilenet.fr","ecoevo.social","howlr.me","goblin.technology","bluenoser.me","whinge.town","xtaldave.net","khp.ignorelist.com","v.st","pouet.it","blobfox.coffee","mythago.space","tty0.social","hackers.town","astronomy.social","v2.flyingcube.tech","waifuism.life","trans.enby.town","cybre.club","so.fnky.nz","mastodon.chriswiegman.com","social.lightlyseared.online","curmudgeon.cafe","queer.af","codatory.com","akko.disqordia.space","pleroma.karjalazet.se","post.lurk.org","101010.pl","aana.site","social.helpmedog.com","social.voidptr.org","dads.cool","hulvr.com","mastodon.express","social.levelxstudios.org","social.pseudo-whiskey.bar","engineered.space","mk.slipfox.xyz","blue.yuv.pink","social.polymerwitch.com","port87.social","social.chatty.monster","anonsys.net","mstdn.mx","skull.website","animexx.de","crimew.gay","piggo.space","kolektiva.social","mastodon.room409.xyz","astrodon.social","ihatebeinga.live","cybre.space","urbanists.social","toad.social","toot.site","m.sclo.nl","pl.tkammer.de","QuarteredCircle.net","snaggletooth.life","writeout.ink","squanch.xyz","social.anon-groups.de","bergstrasse.social","social.handholding.io","pouet.fedisphere.net","mastodon.fjerland.no","kind.social","mastodon.se","canada.masto.host","kith.kitchen","eskuel.net","med-mastodon.com","social.inex.rocks","soc.ua-fediland.de","social.veganact.org.au","queer.group","kafeneio.social","social.taker.fr","mamot.fr","g0v.social","jaesharp.social","mstdn.swiso.org","gleasonator.com","mendeddrum.org","social.balpha.de","arazil.net","theguidrys.us","h.kher.nl","ftp.rip","mastodon.greenwichmeanti.me","fedimon.uk","ambrosia.cafe","stoneartprod.xyz","mirr0r.city","eientei.org","prsm.space","p.enes.lv","xyzzy.link","bikeshed.vibber.net","libretooth.gr","mystic.lgbt","fulda.social","mastodon.tardis.pw","artsio.com","misskey.mewmews.gay","HoFra.rocks","wue.social","berserker.town","hub.volse.no","hespere.de","hellsite.site","det.social","freethinkers.lgbt","mastodon.com.br","lia.fail","linfan.moe","seediqbale.xyz","recurse.social","talkabout.cf","uncorking.me","aus.social","eupolicy.social","tragi.cc","mastodon.iriseden.eu","chinwag.org","shitposter.club","magicalgirl.party","netz.darknight-coffee.org","friendica.chilemasto.casa","misc.name","vt.social","apeiron.aire.ml","bikesare.cool","mk.absturztau.be","ping.the-planet.space","kanoa.de","jade.moe","is.badat.dev","emeraldsocial.org","melb.social","rollenspiel.social","loutre.info","pleroma.elementality.org","toot.coupou.fr","aurochs.moosecow.net","soc.punktrash.club","social.surfnet.space","landofkittens.social","friendica.mschmidt-et.de","squeet.me","social.yesterweb.org","anarchism.space","chrispelli.fun","uvensys.social","anicelittle.network","mstdn.science","drk.network","ieji.de","queer.garden","someone.elses.computer","foxsay.southfox.me","troet.crynet.one","computerfox.xyz","im-in.space","toot.matereal.eu","idlethumbs.social","social.ryan.su","nobigtech.es","pleroma.haijo.eu","social.mootje.be","fandom.ink","diaspodon.fr","mstdn.ca","chilemasto.casa","social.techn1k.de","www.loganjohndarylgraham.xyz","pleroma.labrat.space","wake.st","radiosocial.de","neue.city","social.tromdienste.de","friendica.mrpetovan.com","social.mecanis.me","bananachips.club","peoplemaking.games","social.jazzbutcher.com","kamu.social","pleroma.soykaf.com","ufm.lol","pleroma.noellabo.jp","social.masto.host","skeptics.social","social.freetalklive.com","barcamp.social","troet.cafe","lgbt.io","plma.plus.st","pullopen.xyz","masto.sahilister.in","norrebro.space","fedi.aroace.space","mk.catgirlsfor.science","masto.1146.nohost.me","social.mochi.academy","nerdculture.de","loma.ml","friendica.heikosblog.eu","faithcollapsing.com","skrivel.se","liker.social","pliocene.org","akko.saturno.black","evilcyberhacker.net","democracy.town","social.teci.world","treehouse.systems","mastodon.org.uk","bitcoinhackers.org","t2.thotsofa304.club","oliphant.social","digiwake.net","meowr.me","social.kabi.tk","pl.serialmay.link","sunny.garden","h4.io","towns.gay","social.binarydad.com","misskey.de","pkteerium.xyz","troet.wandel.social","pawb.fun","allegedly.illegitimate.technology","toot.community","travelpandas.fr","birds.garden","spinster.xyz","mellified.men","socialclub.nyc","muenchen.social","queer.hacktivis.me","dragn.gay","mastodon.ar.al","social.bim.land","social.thierrytalbert.fr","friends.johalla.org","depixelated.com","hub.debenny.de","bildung.social","uwu.social","refusal.biz","u8.is","social.bhsnw.com","pouet.couchet.org","lizards.live","fedi.cheeseland.xyz","opensocial.at","gladtech.social","seocommunity.social","deadinsi.de","lewd.town","gts.tailnet.xyz","brockha.us","the.floof.rocks","tuusin.misono-ya.info","social.hergorn.com","soc.kvet.ch","dftba.club","respublicae.eu","cliq.social","todon.nl","sandiegourbanists.com","mastodon.aventer.biz","social.mootech.eu","friendica.kommune4.de","catcatnya.com","mastodon.lateral8.com","toot.si","mas.to","overheard.social","toot.jasonscheirer.com","blockriot.com","microblog.social","unfediverse.com","indoverse.nl","linernotes.club","chirp.enworld.org","mastodon.ie","mastodon.uno","woem.space","hostsharing.coop","lgbtqia.space","cave.mancave.de","friendica.bachgau.social","social.dsmouse.net","m.ocsf.in","girlcock.club","spacey.space","mage.town","mstdn.starnix.network","librem.one","indulgent.art","acegiak.net","tooot.im","exozy.me","mstdn.jp","ak.lightnovel-dungeon.de","xeno.glyphpress.com","sully.site","scalie.club","soykaf.org","hub.hubzilla.de","hostux.social","pleroma.nthomas20.net","vocalounge.cafe","ansico.dk","mastodon.cisti.org","milker.cafe","luna.vg","akko.wtf","xn--trt-tna.sebtobie.de","hitchhiker.social","mastodon.sandwich.net","jasette.facil.services","mastodon.sprawl.club","social.imirhil.fr","pleroma.cafkafk.com","chaos.social","sergal.org","social.servus.at","brvt.telent.net","pixie.town","mond-basis.eu","sweet.succubi.services","goblin.camp","mk.aetheri.ca","novo-atlantis.null.media","go.arkadi.one","mastodon.infra.de","ruby.social","rcsocial.net","infosec.exchange","social.hendrixgames.com","pouet.chapril.org","lain.com","noitl.space","moth.zone","nofan.xyz","iwanna.erase.nz","social.jmueller.eu","notnow.dev","social.anthro.cc","fietkau.social","whitespashe.uk","dragonscave.space","tilde.zone","bear.community","mastodon.pro","meow.zarchbox.fr","friendica.ucy.de","sanguinem.space","conesphere.social","mastodon.electric-goat.net","aaronparecki.com","collapsitarian.io","wien.rocks","kittycat.homes","fedi.underscore.world","mxtthxw.art","social.opendesktop.org","fedi.at","social.lb1a.de","skastodon.com","techhub.social","thebene.fit","social.bau-ha.us","triangletoot.party","social.bitwig.community","cooler.mom","cofe.rocks","starbase80.wtf","fedi.seriousbusiness.international","steampunk.social","donphan.social","geno.social","fri.aethercom.de","bae.st","dosgame.club","sdfn-01.ninjawedding.org","sleepy.cafe","jawns.club","jorts.horse","toots.dgplug.org","mastodon.54park.de","f.kretschmann.social","androiddev.social","bitfudge.com","social.politicaconciencia.org","todon.eu","interconnected.systems","misskey.io","mastodon.linuxbox.ninja","social.chadwaltercummings.me","mastodon.cgx.me","mastodon.gamedev.place","solarpunk.moe","mastodon.com.tr","scicomm.xyz","labyrinth.social","oulipo.social","fosstodon.org","social.anoxinon.de","hachyderm.io","halifaxsocial.ca","signs.codes","gensokyo.social","larkspur.one","is.nota.live","moa.st","slippy.xyz","strelizia.net","fedi.ruinouspowe.rs","wandering.shop","desu.social","smores.town","hcommons.social","social.yl.ms","friend.geoffray-levasseur.org","mastodon.bgzashtita.es","tane.codes","not.acu.lt","glitch.social","freeatlantis.com","wetdry.world","darmstadt.social","cloud-native.social","nya.social","friendica.hashy-net.de","mastodonmusic.social","one.darnell.one","tears.intherain.club","social.katyucha.ovh","social.illegalpornography.com","mastodon.cloud","social.domov.de","social.nicolas-constant.com","x0f.org","social.wxcafe.net","mastodon.audiophilestyle.com","yiff.life","compostintraining.club","toot.martyn.berlin","die-partei.social","scl.clttr.info","toot.payfrit.com","atx.pub","photog.social","social.network.europa.eu","masto.social","loftypancake.masto.host","queer.party","artisan.chat","mobilize.berlin","social.chiefgyk3d.com","cijber.social","climatejustice.global","social.diva.exchange","kakafe.ga","soc.catala.digital","trollian.space","kosmos.social","walkah.social","twtr.plus","xn--p1abe3d.xn--80asehdb","zug.network","writing.exchange","skorpil.cz","k.iim.gay","friendica.ironbug.org","jubi.life","orbitalstation.one","foo.sx","mastodon.zaclys.com","lediva.masto.host","pleroma.1d4.us","boitam.eu","embracing.space","social.doma.dev","aleph.land","aipi.social","fedi.tesaguri.club","social.tarasis.net","girldick.gay","social.dev-wiki.de","a2mi.social","mk.toast.cafe","toots.cordelya.net","kelbie.scot","friendica.daniel-siepmann.de","social.nomagic.uk","k.posix.gay","social.softmetz.de","snowdin.town","mastodon.scot","quietplace.xyz","pl.devfs.xyz","expired.mentality.rip","mk.vulpes.one","cybersecurity.theater","mastodon.gal","my.elven.pw","connectified.com","freesoftwareextremist.com","shpposter.club","pirati.ca","bigshoulders.city","shortstackran.ch","lile.cl","social.alternativebit.fr","thepit.social","snack.social","friendica.offsite.guru","floss.social","ak.kawen.space","ecosteader.com","social.3rensei.xyz","social.dssr.ch","snug.moe","retro.social","unix.dog","brotka.st","friend.camp","misskey.bubbletea.dev","monads.online","social.rights.ninja","mhz.social","kicou.info","mastodon.tedomum.net","kawaii.kitsune.cafe","udongein.xyz","society.oftrolls.com","sarcasm.stream","va-11-hall-a.cafe","manyworlds.fit","mk.mistli.net","silversword.online","romancelandia.club","thebigeasy.space","vibewave.space","amble.quest","oldbytes.space","commiespace.duckdns.org","pleroma.envs.net","orwell.fun","misskey.mymte.de","mk.udongein.reisen","friendica.eskimo.com","gamemaking.social","social.firc.de","social.adamasnemesis.com","blob.cat","pleroma.saturno.black","tiny.tilde.website","anticapitalist.party","mastodon.stefofficiel.me","social.spork.gg","m.noxie.ch","thicc.horse","icosahedron.website","pleroma.breizh.pm","mastodon.indie.host","mstdn.es","woof.group","lediver.se","techlover.eu","chickenfan.club","typo.social","tdd.social","lethargic.talkative.fish","bdx.town","skeleton.cool","nymwars.org","ruhr.social","framapiaf.org","freiburg.social","nahe.social","thetooniverse.xyz","xirion.net","social.emisocks.com","tooting.ch","eldritch.cafe","phpc.social","toot.icu","zotum.net","econtwitter.net","pagan.plus","pachyder.me","en.osm.town","pleroma.dead10ck.com","mastodon.surazal.net","post.ebin.club","fedi.nullob.si","sussyincorporated.net","helladoge.com","emacsen.net","brighteon.social","kudabiverse.com","frontrange.co","social.linuxine.net","edolas.world","masto.nobigtech.es","eureka.chat","hessen.social","mcd.dk","happytobehe.re","mastodon.vlaanderen","mast.linuxgamecast.com","xarxamontgri.masto.host","friendica.me","appdot.net","social.diskseven.com","hidamari.apartments","podcastindex.social","eatthebugs.social","mastodon.matrix.org","evil.social","laserdisc.party","pleroma.kalterwinter.info","pztrn.online","paxation.info","fedi.xerz.one","contenttechtodon.org","openbiblio.social","liberdon.com","simian.rodeo","m.geraffel.net","fedi.tyil.nl","mastodon.green","corteximplant.com","alpaka.social","social.dorf-post.de","firebird.zone","toots.hwl.li","cat.family","bkgrdclrschm.link","social.bennypowers.dev","cyrix.matto.nl","fe.disroot.org","mk.phreedom.club","suedi.club","fedisabled.social","broken.graphics","plural.cafe","shrike.club","social.photogabble.co.uk","yggdrasil.social","mastodon.simounet.net","elbmatsch.de","mastodon.f12n.de","mastodon.randomroad.social","pl.seahorse.sh","neat.computer","fnx.li","machteburch.social","masto.asonix.dog","chat.noelle.codes","social.goodanser.com","pleroma.in.th","pony.social","pipou.academy","nebbia.fail","social.lol","nerdica.net","augsburg.social","social.ppmx.org","mastodon.nu","restless.systems","bidule.menf.in","feeling.lewd.today","freecumextremist.com","motley.club","shitpost.poridge.club","mastogram.com","velocipederider.com","social.secret-wg.org","mograph.social","m.tzyl.nl","dice.camp","mastodon.eus","comicscamp.club","social.funkyfish.cool","freunde.ma-nic.de","dresden.network","rage.love","nimantu.de","social.fedcast.ch","baraag.net","social.xbm.se","half-shot.uk","securitycafe.ca","social.artemai.art","xerg.ga","khiar.net","social.bckr.me","friendica.thewalkingdeaf.net","social.weho.st","mk.chocoflan.net","socks.masto.host","gorgon.city","sozialer.irrpfad.de","monsterfuckers.online","merveilles.town","awoo.fai.st","retro.pizza","mastodon.geekonweb.fr","socialserver.science","social.mythic-beasts.com","raspberrypi.social","appalachian.town","contrapointsfan.club","redeyes.club","blimey.social","gameliberty.club","yulran.masto.host","m.g3l.org","tenforward.social","mastodon.johndevine.co.uk","types.pl","tabletop.social","snabelen.no","blabber.rocks","fedibird.com","social.jlamothe.net","social.nazileaks.eu","eattherich.club","afternoon.chat","friendica.philipp.info","campaign.openworlds.info","ap.maladaptive.art","acc4e.com","xn--trt-tna.wala2x.de","social.thiskurt.me","elle.systems","masto.chronos-tachyon.net","skeletons.gay","piratenpartei.social","mastodon.tech","genau.qwertqwefsday.eu","kinky.business","mastodon.retr0.party","arkham.cafe","front-end.social","gs.leftic.club","scholar.social","microblog.at","w3c.social","mastodon.fancy.org.uk","toot.party","pleroma.wolfie.pw","thedreaming.city","mellow.zone","mastodon.fedi.bzh","furfag.de","mastd.racing","snooter.space","ravenation.club","snake.club","z0ne.social","friendica.minecloud.ro","eveningzoo.club","polyglot.city","mastodon.bida.im","swiss.social","cuties.social","justabit.social","persadon.com","ninjaturtle.xyz","unstraight.club","kcmo.social","computerfairi.es","g1zm0.social","social.drastical.tech","stickynote.amongtech.cc","cybercrusade.xyz","pleroma.gronkiewicz.dev","pl.dira.cc","puz.fun","dog.lgbt","mastodon.radio","spanner.works","bunt.social","mstdn.social","social.jesse-saenz.com","petroskowo.pl","social.scribblers.club","swiss-talk.net","botsin.space","adhd.energy","mastodon.oi7.de","krefeld.life","fedi.ioangogo.dev","wasatchfront.social","nerd.megahuge.com","nicecrew.digital","social.snopyta.org","wiki.style","assemblag.es","is-a.cat","social.wageoffsite.com","x0r.be","social.cativa.net","toot.svenbrier.eu","mastodon.mit.edu","selfy.army","linksgruenversifft.social","akko.chir.rs","gotosocial.kemonine.info","digitalcourage.social","nerfherders.io","social.hoga.fr","medic.cafe","mastodon.bayern"]
0

