HTTP/1.1 200 OK
Connection: close
Transfer-Encoding: chunked
Alt-Svc: h3=":443"; ma=86400, h3-29=":443"; ma=86400
Cache-Control: max-age=86400, public
Cf-Cache-Status: DYNAMIC
Cf-Ray: 767766f88b19b9bf-BRU
Content-Security-Policy: frame-ancestors 'none'; object-src 'none'; script-src 'self'; base-uri 'none'
Content-Type: application/json; charset=utf-8
Date: Wed, 09 Nov 2022 14:57:41 GMT
Etag: W/"f9ebc1345f7f67670c2c6fe5cb1ddcf9"
Feature-Policy: geolocation none;midi none;notifications self;push self;sync-xhr self;microphone none;camera none;magnetometer none;gyroscope none;speaker self;vibrate self;fullscreen self;payment none;
Nel: {"success_fraction":0,"report_to":"cf-nel","max_age":604800}
Permissions-Policy: interest-cohort=()
Referrer-Policy: unsafe-url
Report-To: {"endpoints":[{"url":"https:\/\/a.nel.cloudflare.com\/report\/v3?s=wUrltJRYbf7%2Fz5o5XF3xM3MRCC6je1v2v4tLcd%2BJcPAzjt0F78RHhjcaOI5cQfUSqawpgecgwqoR1k%2F%2BVEvJ9kOlP8KbXFAZP0KCcQxGNgx9VPfAczDwxmH37dInl%2BNqnV3Qkg%3D%3D"}],"group":"cf-nel","max_age":604800}
Server: cloudflare
Strict-Transport-Security: max-age=63072000; includeSubDomains
Strict-Transport-Security: max-age=31536000 ; includeSubdomains ; Preload
Vary: Accept-Encoding, Origin
X-Content-Type-Options: nosniff
X-Frame-Options: DENY
X-Ratelimit-Limit: 300
X-Ratelimit-Remaining: 299
X-Ratelimit-Reset: 2022-11-09T15:00:00.352229Z
X-Request-Id: 0c043a43-6fef-4ac3-be82-56ddbd2fcb79
X-Runtime: 0.037327
X-Xss-Protection: 0

1dac5
["urvogel.club","micro.yatil.net","sms.cybik.moe","ma.sns.onl","status.fsf.org","aqours.run","mk.fabis.cafe","mstdn.kurosuke.org","nightmare.digital","broken.graphics","xe.akirin.xyz","friendica.cz","nerdica.net","twinkaga.in","pso2.club","lianiis.m.to","cpper.xyz","mastodon.stembod.net","pl.remote-shell.net","darkgeek.city","mastodon.ericlathrop.com","fly.singleuser.club","bophadees.witches.live","lkbch.com","www.bookbeezhive.com","toot.chat","soc.emelyne.eu","vidja.social","mastodon.m0t0k1ch1.com","swampfoxden.com","hub.netzgemeinde.eu","coolmemes.biz","shiroganedon.net","www.njp.asia","tuxspace.net","toot.jasonscheirer.com","mk.kaguratech.tk","abunchtell.com","raitisoja.com","pleroma.chillout.chat","nemoroma.ml","limely.social","auspol.cafe","gnusocial.matoken.org","kobold.space","twtr.disqordia.space","fedi.dyke.space","mstdn.hiyuki2578.net","mstdn.inct-densan.club","mastodon.mooo.com","mstdn.wildtree.jp","vernunftzentrum.de","oyakodon.biz","hiddenpalace.zone","social.typica.us","fleur7.com","social.pzn.lgbt","blog.progressiv.dev","mellow.town","plm.bluecore.net","mstdn.xpcoin.jp","loveof.world","social.okoyono.de","social.hidekisaito.com","igel.jpop.club","fediverse.wesnoth.org","shigadon.com","aipi.social","edge.groundpolis.app","f.haeder.net","mastodon.fatty-j.com","social.ei8fdb.org","fedi.at","nsinteger.com","kemoshi.co","lediver.se","yourlife.social","toot.nx-pod.de","thestory.store","social.gemnoc.ca","friendica.mschmidt-et.de","don.inux39.me","soc.pea.sh","bird.waytt.cf","social.inditoot.com","computational.agency","umbrellacorporation.work","cowfee.moe","yamaken.jp","social.opennerds.org","pleroma.bunni.eu","fediverse.bbad.com","mastodon.echelon4.xyz","wug.fun","unstraight.club","m.rutan.info","toot.nerdynate.com","jitakurack.chotto.moe","m.azure.icu","hax0rz.lol","seizemeans.com","goku.zone","pl.skyn3t.in","infinite.pink","mastodon.toniozz75.fr","nyaotan.fun","pleroma.alvogue.com","mi.7ka.org","nutter.io","pleroma.mobi","wasteland.digital","avfig.com","libre-chat.com","not-develop.gab.com","fediverse.keithzg.ca","toot.krinetzki.de","juche.town","snaggletooth.life","mstdn.ijs01140.com","write.lain.haus","kys.moe","hex.bz","bunt.social","assaultffxiv.com","zennou.m.to","social.niicow974.fr","carrot.army","plero.antopie.org","snoot.club","veah.cocoa.moe","grumpys.online","hige.alterna-cloud.com","bitcoinhackers.org","coq.social","cartodon.com","test1.mamemo.monga.site","d.jp-warrior.cf","social.darkpeak.org","clamo.red","masto.rootdc.xyz","dreadsec.social","ia.cafe","randland.party","decentralized.faith","portkaihou.org","social.polymerwitch.com","myselfdot.work","maique.xyz","social.ordinal.garden","linksgruenversifft.social","mstdn.mochiwasa.xyz","raplst.town","social.libreplanetbr.org","social.logilab.org","social.generallyrubbish.net.au","social.bn4t.me","pleroma.gaos.org","stream.void.garden","basedship.xyz","sect.sunbutt.faith","mstdn.poyo.me","computerfox.xyz","lile.cl","social.basementcomputer.site","skrt.social","unkworks.net","f.praschnig.com","joe.masto.host","misskey.fr","privacyfirst.social","stupidclown.fedi.live","mastodon.radiosonline.cloud","ferem.fedi.live","monsterpit.net","mastodon.parleur.net","yumejo.m.to","mastodon.iot.tokyo","cocoronavi.net","social.obrien.ws","misskey.void.gift","bofa.lol","introvert.social","mstdn.vivid-rabbit.com","luvdon.cc","mstdn.kmdkuk.com","mstdn.mikura.cloud","bsd.moe","libertynode.net","honey.town","mordor.social","starship.coffee","pr0mised.life","omochi.xyz","social.sasix.it","don.mlny.info","ap.kitahina.co","sumanko.ml","fedi.neon.moe","oursquad.rocks","sakurakazune.org","pouet.april.org","masto.lagrottedelours.ovh","nyaa.social","lecker.coffee","friendica.mnementh.co.uk","potatofrom.space","cornichon.me","3.14r8.club","bluenest.hostdon.jp","mellow.zone","badadmin.net","jeannie.digital","xn--chuchichschtli-dib.social","maw.moe","f.qrbt.ch","gaze.live-on.net","kanina.be","mamemoma2.mamemo.online","friendica.haroo.ca","snouts.online","otakudon.jp","obitsudon.midyuki.net","sprocket.group","pony.social","ephemeral.glitch.social","s.ystn.win","ping.the-planet.space","4orce.online","mstdn18.net","miyon.miyon.pw","friendica.jb-net.us","social.tsuki.club","mastodon.satoshishop.de","mstdn.yjsnpi.nu","wizzzard.online","spacewizard.space","mstdn.mk39.xyz","mastodon.schemacs.com","devtube.dev-wiki.de","floppy.tokyo","masto.personal.plumino.xyz","nii-san.club","mst3k.interlinked.me","a9z.de","nothing.town","mstdn.serv-ops.com","mn.kitetu.com","melalandia.tk","pleroma.test.wlw.pw","mastodonte.org","md.regastream.com","nadesiko-users.info","nth.io","testing.kawen.dance","linuxlab.sh","yorkshire.social","matus.faith","koolkidsonly.club","social.realnephestate.xyz","tbh.ihatebeinga.live","kind.social","waferbaby.com","lovesyou.zsh.li","haha.rocks","hongeipii.m.to","high.cat","socialgame.mstdn.cloud","pleroma.lclsea.icu","sabbat.hexe.net","mstdn.nukaya.net","a.nom.pl","social.moron.agency","friendica.prankgo.de","cofe.moe","mastadon.jp","gam.m.to","kolevino.com","laviadililith.eu","social.fluffel.io","deagle.club","hostux.coffee","mafumafu.xyz","khp.ignorelist.com","blovice.bahnhof.cz","rigcz.club","line.yamanote.tokyo.jp","pawbs.club","hax0rbana.social","goneaway.social","baraposting.men","cafe.notdeadluna.com","social.deadsuperhero.com","okur.unicornsquad.party","misskey.nl","social.handholding.io","kemoner-don.tokyo","pl.usagi.top","content.town","craftbeer.social","pl.stupid.moe","snootbooping.date","mastodon.coder.town","toot.postea.me","hikoukidon.com","trunk.mad-scientist.club","pleroma.chtisurel.net","greatjustice.net","meemu.org","fedi.place","podlibre.social","pixelfed.tokyo","plrm.polyohm.net","achi.masto.host","uri.life","umaskey.net","tube.rebellion.global","me.paperneko.moe","skeleton.cool","mastodon.sora.pub","peertube.anon-kenkai.com","mstdn.alternanet.fr","social.skankhunt42.pw","mstdn.lilypad.works","fediverse.network","masto.social","mastodon.orani.co","social.mecanis.me","mk.shatteredpalisa.de","mstdn.tyamac.com","masto.ninja","shinonomemilk.com","coom.club","pix.diaspodon.fr","rstdn-p.com","avidol.jp","toyoko.in","misskey.open-w.net","toot.me.uk","social.5jung.com","your.sensor.community","c2bdon.net","m.pika.im","pl.sutera.fi","la-verite-vaincra.com","mastodon.opportunis.me","snel.host","cocoa.me.uk","mineskey.ml","mastodon.lithium03.info","unity.m.to","yakyudon.net","watch.kawen.site","toot.y-y.li","crypto-don.net","fedi.cybre.city","soton.eco","mudl.us","birdsite.link","mstd.tokyo","san-junipero.gimme-sympathy.org","princess.industries","superhamster.tk","post.manj.io","lillimi.com","neurodiver.ge","boop.link","masto.one","misskey.334.ovh","lgbtq.cool","mastodon.thedecentralists.com","mstdn.kwmr.me","wooperlooper.m.to","eihei.net","mstdn.hyogo.jp","pleroma.freeself.one","atri.ml","guillotines.masto.host","mastchan.org","unstoppablecode.org","bricolage.masto.host","evilcyberhacker.net","shadowfacts.net","mastodon.host","social.tr4sh.net","tebukuro.xyz","crunchywatch.uk","notestock.osa-p.net","wirebug.ch","magicalmirro.red","pl.kys.moe","pleroma.tetsumaki.net","mastodon.auroch.be","natter.wtf","phoneboy.fedi.live","honk.codevoid.de","empty.garden","mstdn.kuriuzu.tk","parfait-mastodon.com","tentacle.social","nuke.social","penguicon.social","mstdn.shalyu.run","yamagadon.com","cantos.social","echoz.io","tsugu.utgw.net","lainchan.gay","princess.cat","taketodon.com","budsbots.com","pleroma.hostdon.ne.jp","m.kretschmann.social","community.bluecore.net","mastodon.maxvolu.me","awkward.company","toot.morikka.me","dragon.style","nancy.social","mastodon.raffi.de","chablis.social","c18.masto.host","hitsuji.work","mastodon.linuxlusers.com","ple.watachan.net","toot.ws","wizzards.club","oshiete-programming.net","tessellated.space","testingmstdn.abcang.net","romank.org","social.interru.io","mixin.love","mastodon.sngsk.info","m.aqr.af","simstodon.com","mastodon.tekdmn.me","ap.jadiunr.net","roscoedon.masto.host","ikashima.net","harrystyl.es","m.deeloves.me","lasarna.masto.host","pleroma.eniehack.net","gitmo.tv","pleroma.comfy.moe","social.brokenarrow.network","mi.ne-moni.work","trinitron.town","toots.beep.computer","ahlers.xyz","friendica.multisum.info","dpc.pw","fr.readthefinemanual.net","social.enovale.com","mstdn.klamath.jp","flow.pchost.org","pleroma.ilovela.in","pix.g1zm0.social","mi.makotia.me","pleroma.robertoszek.xyz","mstdn.kgtkr.net","friendica.valvin.fr","abolish.social","dustinwilson.com","pub.mayel.space","mastodon.design.systems","creatodon.online","raspidon.mamemo.online","quasi.social","mastodon.schoentoon.com","freak.garden","social.thesecretlair.org","pl.escapism.work","pikachu.rocks","hitime.space","mastodon.kxn4t.tech","gadget.inpocket.net","ceilingroomba.com","fivebyfive.social","unrest.noize.guru","factory.zho.pa","mellified.men","tower.xyzzy.link","pl.765racing.com","ketsuben.red","tube.lain.church","mastodon.cgx.me","cga.graphics","emoji.msky.work","birdsite.monster","fintoot.space","vucica.net","venera.social","be.cutewith.me","social.lucentinian.com","letallmortalfleshfindtheirvoice.social","vanderwarker.social","gunmastodon.com","feather.city","goose.depht.com","diymusic.space","mstdn.toaruhetare.net","p.node.pk","friendica.opensocial.space","f.iroiro.party","enby.keane.ml","slothy.win","mastodon.laurakalbag.com","incitter.online","social.matej-lach.me","eos.m.to","pleroma.imn-fujita.com","falafel.win","amicable.social","misskey.skk-plasma.tech","mastodon.exp0.ml","takibi.work","vampire.estate","wndp.cloud","mastodon.farman.tokyo","logjam.city","raildon.online","m.uncate.org","dlpn.xn--krsgw--n73t.com","hack.syscaller.jp","toot.link","soc.p-pn.org","home.aqraf.tokyo","happy-oss.y-zu.org","letus.inspiredlife.fun","freegaff.club","lc.imexile.moe","jrgnsn.social","friendica.ennimedia.de","rightmastodon.com","mastde.hirosjourney.com","misskey.t612.ml","social.kindbook.us","mytoot.de","social.imirhil.fr","netstat.app","mastodon.federarks.xyz","ms.kvche.ch","ridixy.com","friendica.produnis.de","www.urbanmind.net","kigurumi.fun","pleroma.store","mastodon.rocks","doubleshine.cc","social.mezzo.moe","pleroma.hatthieves.es","mi.citringo.net","ma.mstdn.jp","mthie.net","forumanalogue.fr","fedi.circuitlocution.com","dg.f5.si","herbo.groupement-interet-citoyen.org","squ.alid.pw","raw.masto.host","cyberfuck.club","xn--6r8h.tk","zeweb.de","micro.baer.works","mstdn01.noellabo.jp","mstdn.wtsnjp.com","social.ikata.co","rva.party","pl.noellabo.com","citadel.thecore.city","apeiron.aire.ml","librenet.co.za","owls.io","deerofnara.net","theinternet.lol","toot.snowgoons.ro","wireless.cat6.network","mycrowd.ca","our.wtf","pickle.zone","mstdn.ikebuku.ro","webcabin.xyz","shiro.dog","nerd.town","mstdn.fujii-yuji.net","ozhika.me","pl.firechicken.net","social.shadowkat.net","arkjp.mhdp.me","asocial.56k.es","mstdn.binfalse.de","matthewgall.chat","egirl.site","mastodon.nrw","mastodon.lfat.de","pouet.couchet.org","tw1tter.com","mstdn.mechkey.jp","pleroma.k4gi.xyz","social.cloudfrancois.fr","m.servperso.net","wiesbaden.social","social.thiskurt.me","mastodon.kotobank.ch","social.ballpointcarrot.net","pl.ohno.host","anime-titties.com","social.curta.red","kartoffel.cafe","mastodon.g2od.ch","social.netdc.ca","upub.komittee.net","km-connect.org","pleroma.xmanifesto.club","aaronparecki.com","fedichive.tk","grindcore.ch","labo.wovs.tk","social.hideo54.com","social.adamasnemesis.com","bots-in.space","mstdn.openalgeria.org","tootteros.me","stopwatchingani.me","ryecroft21.net","soc.hyena.network","camerondcampbell.masto.host","scubadon.jp","conesphere.social","negitorodon.rkunkunr.com","pleroma.inumbra.xyz","tamax.ml","pleroma.fr","mstdn.rocks","majestic.monster","tooting.intensifi.es","friendica.mifritscher.de","syosetu.social","masto.beer","fucking.kaaa.ren","clonis.xyz","artisan.chat","futvretown.com","childcare.hostdon.ne.jp","ministry.moonbutt.science","blacktwitter.io","v.st","xorkle.com","edge.mstdn.jp","ostatus.isidai.com","diaspora.cnova.de","cybre.ninja","junebug.masto.host","w3c.social","pl.wowana.me","animaux.social","hyperion.social","pokemonsocial.m.to","awooooo.wolfgirl.engineering","pleroma.shunderdo.me","gaypxrn.de","synthwave.cc","social.kithop.ca","aseanbar.camp","siberia.work","loganjohndarylgraham.xyz","social.fyeshit.com","inexist.club","glauca.space","assortedflotsam.com","social.anthro.cc","mytoot.net","pleroma.tuxcrafting.port0.org","pleroma.saadnpq.com","wasaradan.m.to","mj12.online","www.spectreleague.net","mastodon.internot.no","noeldemartin.social","edm.haus","puz.fun","pleroma.ch405.xyz","efdn.club","fedi.jort.space","junkhub.org","social.strueker.net","friends.nico","soc.ascraeus.org","misskey.tmin.ml","cb.janusworx.com","awoo.fai.st","hcommons.social","ploen.social","masto.fedi.church","toot.revelin.fr","tigwali.fr","nrw.social","fed.lexiphanic.com","freak.university","tokotodon.m.to","mstdn.mell0w-5phere.net","conjured.space","social.sgawolf.com","tha.closed.social","friendica.tttproject.de","hotwife.social","mastodon.wakin.site","md.arg.vc","pl.eragon.re","bitcoinplebs.net","at.weep.jp","gamecreate.mstdn.cloud","retro.social","pleroma.dereferenced.org","z-flag.work","13bells.com","dlpn.skk-plasma.tech","mastodon.memo-village.online","swingset.social","video.lqdn.fr","cum.coffee","pler.gtx.dynu.net","yah.vn","friends.lesbian.energy","insoumis.social","bigdickisbackintown.futbol","don.suwa3.me","wired.socotrine.com","orbsafe.masto.host","the.giant.horse","mstdn.haun.jp","mastodon.club","fedi.samtherapy.net","toot.io","imastodon.blue","wellduck.me","twit.dispersio.us","cope.rage.lol","antisocial.2soc.net","curmudgeon.cafe","mstdn.mlmie.net","soc.eleos.space","social.rustysoft.de","masto.noho.st","social.troll.academy","pleroma.jonquan.cf","mastodon.wivodaim.net","amdyes.fun","social.sivokon.me","sm-mstdn.com","mstdn.lucida-memo.info","sheikah.online","mstdn.awa.sfc.keio.ac.jp","awoo.pub","oniko-branch.moe","bantha.tatooine.space","fedivers.net","broadcast.wolfgirl.engineering","pomdon.top","cyberpunks.xyz","toot.loner.jp","community.thequantumblockchainproject.com","pl.rokoucha.net","kapselschriften.masto.host","groups.qoto.org","kanoa.de","oldbytes.space","social.1in9.net","mstdn.kawamr.com","xxx.m.to","mastodon.kitamurakz.com","f.a80.fr","social.stuartbrand.co.uk","gensoukyou.jp.net","misskey.xn--krsgw--n73t.com","dolphin.lunet.org","mst.vsta.org","toppickz.com","kitty.church","mcphail.uk","necessarius.church","ding-dong.asmodeus.tokyo","mastodon.grin.hu","oneway.masto.host","kuketz.social","cthonic.club","dev.slum.cloud","lia.fail","nomoresha.me","verge.info.tm","fedi.hazel.cafe","pl.uwu.is","pleroma.okashi.me","mdn.crows.tokyo","mastdon.amazedkoumei.com","cursed.frinkel.tech","disqordia.space","masto.giga.is","skrivel.se","waifu.social","mastodon.ochronus.online","gwomp.com","mastodon.tmp1024.com","stickynote.amongtech.cc","kowai.youkai.town","redterrorcollective.net","thesenate.cc","ennui.industries","sakura-jk.tokyo","t.cascadians.net","spring-has-come.tk","mk.danksquad.xyz","rafting.io","dickkickextremist.xyz","mstdn.boxp.tk","kirche.social","jpop.club","lumpen.work","social.mjb.im","fosdem.pleroma.lol","desvox.es","mastodon.gargantia.fr","popeinjapan2019.hostdon.ne.jp","the.monsterpit.net","friendica.cwiwie.org","ncr.m.to","mastodon.kaonet-fr.net","pl.stp.cx","mstdn.ryutoto.com","imastodon.org","wordsmith.social","social.anaproy.nl","mastodon.jordanwages.com","social.tryptophonic.com","misskey.zirconsoft.net","introverts.social","misskey.kazu-server.tk","pleroma.my.sekai.netlib.re","15.distsn.org","tmi.pics","pixelart.moe","cascadia.news","mastodon.neso.tech","mstdn.usagi.top","blog.funkwhale.audio","engineered.space","kira-sei.com","slime.dragon.garden","blog.mevo.xyz","pl.8mitsu.net","beeping.town","epicyon.freedombone.net","habbnn.com","iamveryti.red","dystopian.fun","syrup.zone","gammon.club","social.firc.de","social.pcwideopen.com","mas-to-don.be","3dots.lv","bobadon.co.uk","nihongoposter.club","russiandiaspora.org","social.privacytools.io","edolas.world","nervesocket.com","social.radio.af","disarray.nof.st","nitroet.me","m.kuko.hamburg","godspeed.moe","sns.hotaruxd.me","social.avoh.club","masto.borked.sh","11.distsn.org","mame.m.to","social.wildeboer.net","activism.openworlds.info","mstdn.imoimo.xyz","berries.space","zhenmei.li","ashikaga.link","ourempty.pub","338338.xyz","niedersachsen.social","wasara.masto.host","kuroringo.com","sns.d-rine.com","boltcarrier.group","don.wakamesoba98.net","ngndn.jp","lamp.institute","mstdn.swiso.org","sina.moe","social.backbord.net","toot.lu","taiyaki.online","thefire.work","social.cloudron.io","keelung1.ddns.net","snack.social","altdn.me","objective.ninja","campduffel.social","feminism.lgbt","masto.werefox.dev","meety.me","thaisocial.in.th","masto.cloud","waraiotoko.net","barcamp.social","soc.freedombone.net","social.finkhaeuser.de","tsuki.network","east.mstdn.tokyo","pleroma.slum.cloud","mastodon.oeru.org","queer.town","mstdn.inkyara-kami.me","gerzilla.de","d20hero.club","hellwife.online","psyopshop.com","sen.jamiesnotes.com","mastodon.corecoding.dev","mammoth.nerdpol.ovh","social.melonbread.xyz","lets.saynoto.lgbt","misskey.omhnc.net","pero.knoyism.net","lucida-note.info","qpomelo.cc","k-shiigi-136.masto.host","mstdn.dasoran.net","pouet.it","mastodon.otherreality.net","soc.tachibana-labs.online","photodon.org","frogmob.life","social.artemai.art","attoch.org","steam-don.fun","nyan.mdn.hinaloe.net","pleroma.travnewmatic.com","don.m2hq.net","pl.rly.cx","analogue.social","mastodon.odat.xyz","don.crakac.com","islamicate.space","usocial.fr","mastodon.humanistische-union.de","stupid.moe","tootsfrom.ahabitual.dev","social.gattai.net","zef.social","osrc.pw","saigyouji.cyou","testdon00001.mamemo.online","pleroma.weirdart.space","pl.im-in.space","freevoice.space","chat.noelle.codes","pleroma.aorinngo.ga","social.bim.land","daishouri.moe","pl.poo.li","tackett.family","hota.hirachon.otakan.jp","pleroma.atsuchan.page","cyberia.icu","honk.seahorse.sh","permaweb.io","mastodon.sandwich.net","tutoteket.no","nekoyama.masto.host","yknk.work","noblogo.org","setl.ist","social.azkware.net","jiro.m.to","voxcry.pt","mastodon.popps.org","m.takamoriai.co","masto.dev.host","chomp.life","mastodon.eric.ovh","aesthetic.strangled.net","mastodon.yousack.net","heck.ooo","hacase.m.to","cronk.stenoweb.net","pleroma.strizhakov.dev","gab.protohype.net","whitespashe.uk","brave.cafe","southflorida.social","mastodon.tackman.info","allnutt.net","rtx3070kure.net","9177xe.tokyo","social.mrhands.horse","pleroma.broccoli.si","comics.town","chorus.space","mstdn.uec.tokyo","social.skewed.de","redliberal.com","quesos.io","mashtodon.net","arguos.com","journalist.social","fabler.su","misskey.m86.work","pleroma.glueoh.com","hub.spaz.org","www.fediversekey.com","fediverse.initialization.tech","mstdn.atcurio.com","squeak.live","mochiwasa.online","nemosrv.ml","nikki.m.to","fedi.allot256.net","artalley.social","otter.tube","pl.sadx.moe","mastodon.bayern","nitrokey.com","sub.fediversekey.com","claris.cf","social.wiuwiu.de","dolphin.xn--931a.moe","def.social","satania.space","mstdn.doxa.jp","canic.us","p.a3.pm","ap.tiuxo.com","toot.canberrasocial.net","yuwinet.win","misskey.ranranhome.info","toot.cafe","friendica.code-alongsi.de","pleroma.ljosalfar.io","council.azure.icu","toot.icyphox.sh","lrtg.cf","donteatanimals.org","moooon.network","metaller.m.to","pgh.social","social.skiqqy.xyz","wndp.masto.host","counter.fedi.live","hoops.masto.host","virtual-kaf.fun","botta.social","fedi.kitteh.pw","mstdn.linfiel.com","dialup.express","thedisco.social","social.cyberpunks.xyz","pleroma.rojogato.com","pokemon.men","atomicblon.de","chaoscult.org","mastodon.eus","pleroma.galaxy.cat","fedi.offrealms.space","mstdn.rosaceae.net","feed.victor.earth","unexpected.singleuser.club","myon.slimed.org","m.eula.dev","mstdn.taiyaki.online","lyo.social","rayn.bo","m11.t8n.dev","antisocial.swagosaure.com","epistolary.org","toot.zone","fr.zy.lc","dansmonorage.blue","heislandmine.mydns.jp","misskey.fluoride.dev","ntrpg.net","wrongthink.me","djsumdog.com","sansschatten.com","pleroma.miguelcr.me","social.isharacomix.org","heidel.berg.social","cdstm.ch","azumarill.net","bangdream.space","obkkszd.club","mastodon.lt","afterlife.masto.host","hiruandon.life","syuwa.fun","pl.lust.works","pewtix.com","pleroma.efwends.xyz","pleroma.eientei.org","mtd.jerstation.com","social.loranger.xyz","social.tromdienste.de","friend.3sn.ru","miaow.gay","epic.meme.moe","xoxo.zone","social.spacebear.ee","pleroma.rotten.network","pleroma.astralchan.xyz","talknet.akabe.co","pleroma.dark-alexandr.net","pl.busshi.moe","social.lescorpsdereve.space","homo.dev","wenzlik.social","yukoyajp.masto.host","lucida-don.net","babymetal.party","friendica.utzer.de","aardlark.co","lazybear.social","ap.magitek-telescope.im","hearthtodon.com","elict.net","toot.baby","spacekittens.ru","xiii.ch","cyberia.social","fedi.mint.lgbt","boing.world","mastodon.minecloud.ro","tomodachica.app","friend.pierobosio.info","pl.smuglo.li","pleroma.hrstva.org","bungle.online","ap.2p.gg","mstdn.ryecroft21.net","freeframe.masto.host","hub.debenny.de","social.joshuacasey.net","z.digitalesparadies.de","qnmd.info","furige.m.to","7.distsn.org","kicou.info","f.jymuoyu.com","social.cofe.space","pleroma.amplifie.red","mstdn.sastudio.jp","social.nulltrading.com","rainbo.ws","zetsubou.ryona.agency","mastodon.umikaki.net","pleroma.best","mstdn.binfish.jp","iscute.moe","social.morsdorf.io","cybre.city","oninawa.masto.host","wuppo.allowed.org","lorazepam.distsn.org","elbrus.mentality.rip","crowsnest.libre.audio","hackoon.com","orachat.masto.host","cybur.nl","is.badat.dev","social.avery.cafe","sprite.land","p.ccp.ovh","ap.auri.ga","social.sphere.com.ai","sn.nekojita.moe","lost-angles.im","m.moriya.faith","zombienet.org","dummy.cafe","nixeneko.info","unkomaker.m.to","social.pmj.rocks","gorgon.city","barrir.ca","gensokyo.town","fedi.danmaku.moe","teaguild.dev","logi.fun","metu.life","kolektiva.media","dumpkin.monster","suki.tsuki.network","sumou.fun","ecodigital.social","pl.istukiy.com","shikisom.m.to","kenhou.info","mujo.xyz","lesbiab.space","svariyar.com","hightops.ink","md.paoon.social","gabfed.com","socnet.supes.com","msdn.garapagos.online","maho.app","nemotodon.tk","meld.de","toot.boritsch.de","pixel.artemai.art","s.noyuno.space","mi.cryo.jp","pleroma-netwalker.home.js4.in","mastodon.alienlebarge.ch","has.foxiepa.ws","mst.nanaaki.com","soc.zom.bi","social.chicoca.net","pl.pech.tech","democord.masto.host","pleroma.runfox.tk","mstdn.tomokiwakimoto.com","systemd.lol","benis.freemyip.com","griftgang.com","pleroma.ahmedsaad.xyz","hub.mtf.party","social.planamag.com","skoops.social","augsburg.social","sin.tyaku.com","social.thesifr.com","buckeye.social","greenlifeplus.net","zeppelin.flights","ravenvale.lubar.me","mastodon.com.pl","mastodon.comwork.io","mastodon.chriswiegman.com","zhenya.masto.host","machteburch.social","real.fakeclimate.science","mastodon.infra.de","r18don.xyz","nonexiste.net","the.scream.zone","mastodon-relay.moew.science","xn--lofll-1sat.is","schleuss.online","fediverse.projectftm.com","redeyes.club","cute.science","confederac.io","don.zatta.dev","mastodon.soses.ca","postpandemicparty.org","ichii.moe","georgi.family","ubuntu.social","wordsmith.reverie.club","hentai.agency","queersin.space","social.alternativebit.fr","freezepeach.online","dlitz.net","mstdn.blue.wirednet.jp","mastodon.lw1.at","rollerderby.social","me.frankmeeuwsen.xyz","mstdn.suzume.life","i.misskey.love","lunai.re","opantu.opantu.site","mewl.me","yodok.bunkerchan.xyz","ap.torlipen.net","neighborli.xyz","m.fal.moe","totallylegit.site","hammy.masto.host","memesouls.top","ramen.iu0.win","social.mayfirst.org","social.vbrlabs.io","hohoho.northpole.host","mstdn.nielniel.net","drake.network","b612.me","noitl.space","mk.kigurumi.fun","guimik.fr","pleroma.miniwa.moe","deima.sh","pl.pube.tk","mghk.space","sakaba.space","waldn.net","pom.m.to","social.medusmedia.com","artoot.xyz","jw.be","fedi.fullstuck.net","paw.cafe","pleroma.labrat.space","eocial.com","microblog.getcyca.com","dp.akane.blue","social.holdmybeer.solutions","misskey.levome-dol.com","devolutionnet.com","friends.tausys.de","tribefeed.online","m.bnolet.me","yuntalk.mywire.org","soc.redeyes.site","mstdn.es","programmingsocks.com","kernel.social","misskey.azuki.cf","azuchi.m.to","soulice.moe","producers.masto.host","social.dtluna.net","scifi.fyi","pars.ee","mastodon.chimera.website","mi.pede.rs","sgp.hostdon.ne.jp","pl.craftplacer.moe","social-dev.matcha-soft.com","toot.rainbow-100.com","signs.codes","ikisugi.m.to","mstdn.tentere.net","piconic.co","quarteredcircle.net","dp.xiupos.net","chibi.kemo.no","sagephoenix.org","lfsr.net","x41.social","tromsocial.tk","huwa.m.to","plr.ph3j.com","msbtn.m0r016.net","fedicy.allowed.org","dxm.m.to","mstdn.sahagyo.com","tachibana-labs.online","eodai.net","quench.theburning.world","straylight.expectnomore.net","mastodon.jlg.id.au","aachen.social","toomanycooks.social","neet.church","sperg.city","social.lsnet.eu","pleroma.uwah.moe","disney.host","mastodon.oita.jp","friendicarg.nsupdate.info","lewd.town","gbtdn.tokyo","icyphox.sh","dyketwitter.masto.host","jergefelt.se","soc.kakun.jp","germany.presentdaypresenttime.com","tkmb.tokyo","dolphin.nieein56.me","mctetsudou.net","opsecwin.com","social.evilma.id","syamutodon.xyz","mi.potofu.moe","mastodon.davidpeach.co.uk","social.supernerdland.com","soviet.nyc","social.schuppen.dev","msk.minetaro12.com","lemuspeschel.com","jako.social","dipshit.space","desuposter.club","mastodon.pinheirodeabrantes.pt","adney.land","masto.libre.brussels","ligma.pro","mastodon.star-one.org.uk","mastodon.gsalucci.dev","microblog.pub","miss.oikura.site","mastodon.edufor.me","mstdn.nil.nu","degenerate-senate.online","mastodon.in.th","defenders.town","s1ttidoe.com.tw","misandry.city","weep.m.to","caonima.wtf","aidev.ru","diary.yukimochi.jp","d.qp3.uk","kosendon.tech","sdfn-01.ninjawedding.org","oliverfalvai.xyz","the.goofs.space","pl.kotobank.ch","mastodon.hk","foxes.life","fedibird-dev.jp.ngrok.io","tooting.ai","mastodon.maho-do.jp","iro.moe","pleroma.poslovitch.fr","m.xjmaoyaoyao.monster","umbra.helios.red","hub.tschlotfeldt.de","werd.social","satania.site","alanae.net","mustardon.tokyo","itsover.cyou","wolf.masto.host","mstdn.9mmtylenol.me","xn--28j0ea.tokyo","harpy.life","sakura-rage.net","ewaf.club","social.midwest.af","friendica.hellquist.eu","moonbutt.science","pxlmo.com","social.linc.systems","quey.org","a-room-ones-own.me","mastodon.ocert.at","sozial.derguhl.de","econtwitter.net","mastodon.zeteo.me","cijber.social","mastodon.spotek.io","shivering-isles.com","araidon.m.to","gleasonator.dev","mastodon.neilzone.co.uk","pleroma.ohgro.net","soc.ialis.me","mst.ijs01140.cf","mbp.limited.systems","moji.m.to","knoxodon.com","friendica.xyz","sukebeneko.com","prinsesse.co","xy.ag","gouhuoapp.com","wake.st","social.hwc.brussels","mk.godspeed.moe","social.simcu.com","mstdn.unasuke.com","megadon.net","mstdn.urishari.com","ma.steffo.eu","fediverse.robotham.dev","mastodon.starshipchangeling.net","d100.club","o.kagucho.net","v1x3n.net","mal.systems","social.gerotintin.com","thebigeasy.life","blackmesa.space","libresilicon.com","deguuuuu.xyz","scy.name","gececibaykus.com","ms.osanhost.mydns.jp","p.pleasecuminside.me","social.anjara.eu","displaced.social","mstdn.futaba-works.com","cybergay.space","ecosteader.com","misskey.i2p.rocks","the.hedgehoghunter.club","fuguri.site","m.nintendojo.fr","social.zwei.net","realabc.masto.host","animeartist.social","mstdn.sasachi.tokyo","tryfriendica.de","xn--3-pfuzbe6htf.juggler.jp","mahou.shoujo.xyz","msk.mozcmozc.club","social.staspikin.com","comrades.abortu.com","pleroma.fuwafuwa.moe","pretest.misskey.id","musicdn.jp","misskey.soldyn.net","mstdn.rkunkunr.com","yokai.cafe","saigodon.jp","gnusocial.no","jackdaw.today","social.linuxine.net","social.redxen.eu","friendica.chocoflan.net","misskey.kusoneko.moe","pl.naotodon.xyz","donotsta.re","cobaltkiss.blue","snuskete.net","mastodon.hhhammer.de","md.neko.bar","mstdnsrv.moe.hm","pokemon.m.to","fedi.tesaguri.club","mastodon.tianshengli.me","metal.thrash.club","toast.cafe","finkasaur.us","social.byoblu.com","fanontodon.zapto.org","me.ns.ci","pleroma.in.th","libertica.space","mastoc.net","mstdn-bike.net","pleroma.xn--t8jzbl7g.jp","m.natalie.ee","mstdn.neso.tech","kamu.social","capybara.social","serious.ferret.business","loutre.info","mastonederland.nl","telepati.ch","mastodon.aximov.net","queer.hacktivis.me","transmom.love","bydons.ddns.net","w3rkhof.zone","ne.codes","pleroma.gidikroon.eu","grand-duchy.net","iftn-mstdn.pink","philos.fkn-systems.de","inherently.digital","pl22.telteltel.com","chinamstdn.com","drive.home.neso.tech","ilja.space","djitter.com","pl.smoothbrain.top","uzege.masto.host","pix.benpro.fr","ghostgirl.princesa.company","welldn.net","kawauso.ml","glowers.club","mastodon.socdojo.com","dolphin.skk-plasma.tech","matchdon.com","ryuryu.tw","nya.social","toot.matereal.eu","social.sociopathic.ca","gorone.xyz","secret.intelme.com","mastodon.moe","pleroma.topcat.io","masto.ashfurrow.com","holmmade.cafe","hidden.blue","bemani.world","nakasendon.m.to","skirota.mhdp.me","lol.dydx.moe","inditoot.com","telco.m.to","pixelfed.nz","bantu.social","social.slat.org","m.parkgaedae.com","glaros.xyz","mstdn.osaka","opensocial.at","social.fym.moe","arktos.social","mastodon.anzui.de","toot.shoes","social.omniatv.com","surrealism.life","this-is-epic.space","socialwagrien.de","pl.mastodont.cat","pleroma.chimerae.org","b.worst-friends.chat","foowar.de","neotag.net","mstdn.cosnomi.com","f.kretschmann.social","pleroma.subzone.net","alonecomplex.xyz","social.hacktivis.me","pangu.hengsha.host","social.abnd.space","tamx.tk","pixfed.com","mstdn.progressiv.dev","otadon.com","succubus.town","anonymous.wtf","co-mastdn.ga","mstdn.tw","toots.alirezahayati.com","social.sunshinegardens.org","mstdn.albormentum.com","iguanodon.net","mastodon.rylees.net","mastodon.davidpea.ch","mao.daizhige.org","mastodon.thekurokuma.net","deaf.rocks","girevik.su","jiji.su","august-don.site","cutls.com","pl.eternawings.com","masto.glx-consulting.com","social.macaw.me","social.tsun.co","medievalist.masto.host","honk.tedunangst.com","pl.asterism.xyz","beefyboys.club","ms.technodro.me","mstdn.tokyo","magicalgirl.party","midnight.dance","mastodon.amaseto.com","oaks.rocks","soc.fglt.nl","social.badabam.net","mastodon.transneptune.net","mstdn.hitoxu.com","dozine.xyz","kero.ccsakura.jp","wedistribute.org","kitsunet.net","von.einzbern.moe","pl.cleac.me","furrytf.club","that.world","mstdn.nacika.com","m5y.usuyuki.net","berserker.town","lasershark.army","paws.moe","barritar.uc-netcorsoft.de","cute2d.xyz","epichairekakia.com","social.canony.xyz","milkey.homes","social.farend.co.jp","snel.social","mastodon.nogods.be","social.outv.im","ap.umedasp.co.jp","glittering.diamonds","yuuyaap.aa0.netvolante.jp","social.servus.at","masto.evelynyap.com","biwakodon.com","patchouli.today","pleroma.miraiv.net","misskey2.juggler.jp","fedi.culturewar.us","nuklear.family","kagerw.m.to","social.catgirlsin.space","magicvampirepirates.com","ap.sevvie.ltd","social.targaryen.house","maki.chiba.tw","mastodon.gummipunkt.eu","howlr.me","mastodon.elte.hu","mastodon.noraworld.jp","social.azure.icu","social.bfoliver.com","extranet.palaven.space","pl.anon-kenkai.com","mastodon.linuxkompis.se","dragon.garden","masto.yaeghs.net","kidsdon.love","quitter.im","mastodon.sedryk.info","social.up.edu.ph","bunny.blue","etimon.app","undead.link","britain.masto.host","nya.house","togart.de","social.sidekek.ml","crypt.shedsys.space","mastodon.irgendwo.social","mastodon.foxtrot-community.cc","charmed.social","scl.zmb.cm","freewheel.social","tuiwen.live","atlas.fedi.live","cursed.technology","social.brevsprekk.net","loquat.social","social.hendrixgames.com","queenlainsrevenge.xyz","akm.longyap.name.my","cmpwn.com","social.cutie.live","mastodon.dvk.co","americassweethe.art","comp.masto.host","mstdn.monappy.jp","soc.kvet.ch","pl.jodh.us","imd.social","pokemon.homes","salesforce.social","eizodon.jp","hiker.camp","social.guizzyordi.info","eattra.sh","c3po.bashell.com","p.run-girls.run","goldandblack.xyz","tucson.claims","misk.thinaticsystem.com","celestialspheres.xyz","toot.typetura.com","pleroma.apelsin.space","fsmi.social","sc.sigmaris.info","gnusocial.cc","omoro.info","riondon.miraiv.net","queerfem.space","fedi.nobrain.org","naokisz.tk","universe.feliver.se","mtr.masto.host","reconnected.cat6.network","meme.garden","tube.hoga.fr","p.black6.dev","mastodon.potager.org","norge.social","lubar.me","kawaiistu.moe","misskey.nokotaro.com","pl.longyap.social","social.fedyya.net","mstdn.barippi.com","sierra.fedi.live","node9.org","mxtthxw.art","fedi.jmizzle.com","miestodon.com","boonchat.xyz","mstdn.incmplt.net","mastodon.brnrs.pl","freewahaextremist.wtf","mast.udn.jp","babuu.club","ushio.o-man.co","social.n0.is","pleroma.anduin.net","plz.nobulli.me","v01d.app","then.therewas.art","open.tube","ps.m0n5t3r.info","mastodon.toni.im","misskey.myhome.cx","mi.nafuchoco.page","sapphos.be","groundpolis.nokotaro.com","test.worst-friends.chat","mstdn.miyacorata.net","close-air.support","pleroma.tempus.tk","me.noorul.xyz","mastoid.dev","om.nom.pl","social.the-thirstiest-mawile.com","maddypa.ws","roxxers.xyz","federation.krowverse.services","social.foxfam.club","meows.life","social.quizmo.mn","sci.kiwi","mbl.social","pleroma.xianon.net","masto.vy-let.software","social.bund.de","fromm.social","mstdn.nekonote.cc","www.bigguys.club","mastodon.gnudoux.org.ve","pltest.feminism.lgbt","activitypub.coro3.net","pouet.jablon.fr","nyoki.club","uwu.town","safe.millennial.space","social.th4music.net","eunivers.social","rzl.icu","le.sakana.cx","anarchism.space","wetfish.space","mastodon.yokohama","timcast.club","mastodon.zwei.net","pettingzoo.dev","social.net.ua","mstdn.nagasaki.jp","aana.site","beta.romne.co","mamot.fr","noagendasocial.com","mstdn.yakitamago.info","smolkitty.me","mstdn.dgm.pw","moon.holiday","lejaua6.club","hub.witcraft.de","social.mrcol.es","pleroma.gretagangbang.biz","toot.jeena.net","mstdn.tokyocameraclub.com","miyon.miyon.org","starfleet-command.org","fedi.underscore.world","social.mass-trespass.uk","asonix.dog","pleroma.ebola.moe","m.aonyx-cinerea.fun","cocaine.moe","wotahime.m.to","tubplex.org","lostsock.club","barkshark.tk","social.datsemultimedia.com","ebf.io","msky.naru.cafe","goodchristian.website","mastodon.supersandro.de","matt-social.co.uk","lets.bemoe.online","fumufu.xyz","social.umeahackerspace.se","soc.h4x.group","mastodon.niu.ne.jp","pleroma.nakanod.net","mstdn.toyoko.in","uwu.st","magro-avocadon.m.to","freemarketbastard.theburning.world","ligthert.net","noisemaker.tokyo","technophobian.xyz","tryliberty.org","social.getgle.org","fedi.neufv.systems","hubzilla.konzurovski.net","ap.thequietplace.social","mstdn.liliso.com","don.nako.ne.jp","gs.yvt.jp","byou.social","northeast.one","cryptocartel.social","prismo.news","mofu.kemo.no","zap.haru-jishnu.eu","toot.ear7h.net","3.distsn.org","mastodon.wusz.org","burr.is","irishstew.org","m.fedyya.net","mindlesstux.com","chaldea.network","dolphin.test.wlw.pw","jaesharp.social","social.moseskaranja.com","nt.mstdon.app","ap.fourth-brigade.jp","hub.sakuragawa.moe","endhill.masto.host","pleroma.einzbern.one","bikeshed.party","es.muy.moe","alserver.jp","mythago.space","fedi.desvox.es","social.frbg.me","mastodon.artsandco.de","itras.by","poisonousherb.m.to","social.myconan.net","melb.social","dolphin.usagi.top","svrdn.drillion.net","pleroma.ga","paors.lv","bark.house","cave.m.to","fedi.mysticcabin.xyz","hyenas.space","a.rathersafe.space","pleroma.kamp.site","live.remilia.me","welsea.site","mi.siotter.tk","friendica.m14xa.ru","dev.mis.b-shock.org","herosofbionicals.bigchungus69.club","pl.manwho.re","m.mtlynch.io","cybersecurity.theater","sb.jeuseweeder.xyz","social.devopsgenius.com","social.huginn.dev","ggtea.org","zer0.click","clubhouse2.net","twinja.club","loci.onl","club.darknight-coffee.org","social.lukepreston.xyz","text.techknowlogick.com","daffodil-11.org","social.adlerweb.info","pl.brechanegra.net","sanctuary.masto.host","yakumo.foundation","freezepeach.xyz","mastodon.skrep.in","quitter.pl","warkr.me","ecoevo.social","toot.thedoodleproject.net","soba.gentoo.app","mikeinspace.nl","4wtf.com","neckbeard.xyz","coolbowties.xyz","t.aqn.jp","p.enes.lv","peertube.uno","impenetrable.fortress.promo","less.re","pleroma.oook.fr","froth.zone","animeisgay.com","pleroma.skyenet.online","fine-net.site","test-hello.2heng.xin","mstdn.nokok.net","quinnter.net","haskell.social","mstdn.pcsfield.com","yulran.masto.host","mastodon.the-orbit.net","fedi.petras.space","sysadmins.zone","social.warsow-online.de","mist.so","mastodon.lu","goodman-wilson.com","s.ovalerio.net","mast.wholemars.com","soc.canned-death.us","mastodon.lermer.nl","ilovela.in","social.toromino.de","lrtg.tk","share.tube","social.rebellion.global","maple.asria.jp","nokotaro.com","mastodon.webseed.com","naos.crypto.church","pooper.social","animal.business","m.heine.xyz","pl.ucode.space","netzsphaere.xyz","xmflsct.com","puddle.town","programist.ro","412000.xyz","nsfw.wnymathguy.com","ethiopia.server-on.net","mastodon.nu","mikeinspace.duckdns.org","austin.community","mastodon.diglateam3.com","misskey.osyakasyama.me","mi.ijs01140.cf","gentoo.live","fedigram.com","masto.powerlot.net","mastodon.matrix.org","chikuwa.sweak.net","cybercat.cc","bandwidth.camp","yojinokuni.m.to","mosw.work","dontbulling.me","lono.space","pl.bhh.sh","sihailiuyun.gift","guineapig.party","social.patapouf.xyz","soteria.mastodon.host","torlaz.online","mstdn.techdrive.top","isekai.wtf","msk.kirigakure.net","gitmo.life","kaisendon.asmodeus.red","cyberia.nessel.cloud","abbotsfurred.ca","plrm.beanlog.xyz","mabe.space","blockriot.com","mstdn.gots9713.xyz","diaspodon.fr","msky.jnsk.info","mstdn.ht164.jp","manhole.club","naotodon.xyz","pleroma.cucked.me","fairground.moe","hash.social","rly.wtf","mstdn.helios.red","phreedom.tk","mastodon.naii.io","mastodon.hptrow.me","a.daizhige.org","marivron.com","twitchain.net","shigoto.site","cyber.acid.im","free.gluten.space","russtodon.ru","sadposting.space","social.fanyx.xyz","pl.qorg11.net","pleroma.tuxcrafting.cf","artritelacy.jp","hokutodon.co","pleroma.pandanet.moe","norimono.moe","pleroma.striker.net.eu.org","mastodont.social","mk.fedi.tech","hubzilla.dark-alexandr.net","mastodon.arbleizez.bzh","social.grimneko.de","misskey.amoonrabbit.reisen","runlinux.net","mastodon.natrinicle.com","birdity.club","microhive.net","mstdn.cosplayer.com","spanner.works","social.nipponalba.scot","pub.sectorinf.com","social.afontaine.dev","anem.prou.be","bakabakufu.nsfw.cafe","masto.tech","lo.hn","kompost.cz","manowar.social","dotdon.m.to","orebro.online","toot.brussels","coletivos.org","mastodon.technology","sac.moe","kodachrome.club","video.aqr.af","kitakamirei.ca","soc.nhg.moe","grenland.social","mastodon.ctseuro.com","nitro.horse","beehub.org","toot.travnewmatic.com","pleroma.dupon.in","dog.estate","misskey.ml","kith.kitchen","makhnodon.club","intahnet.co.uk","hentai.baby","root.casa","uncontrollablegas.com","ramshackle.town","arcade.ooo","pub.miniverse.social","pleroma.hidamari.blue","taggit.me","social.thierrytalbert.fr","twitter.rumiserver.com","fedi.network","social.linuxlusers.com","mastodon.wakayama.jp","social.surfnet.space","cipioshouse.xyz","nekos.io","nejiamasi.com","mastodon.eastback.co.jp","mstdn.vodka","agora.echelon.pl","krefeld.life","mcncraftodon.site","pl.moggy.xyz","bear.community","mastodon.fail","lukasrosenstock.net","thewired.xyz","sawakai.space","audiochad.xyz","mastodon.matcha-soft.com","toot.click","masto.willow.cafe","social.mysticmode.org","qunagi.qunagi.net","scamdemic.party","deepsea.masto.host","kig.life","social.dbonnet.ovh","mstdn.mynoghra.jp","nya.lemonade.moe","pl.komittee.net","misskey.mametsuko.net","mastodoll.net","huskyapp.dev","social.scambi.org","m.g3l.org","deepsea.m.to","social.hackerfraternity.org","m.rthome.me","foo.sx","mastodon.darkou.fr","librem.one","masto.waytt.cf","toot.payfrit.com","mainburg.hallertau.social","takeoverthe.world","assorted.paupers.xyz","the-box.work","social.digitalcastle.me","awoo.church","whomst.dog","mithuru.online","ro-mastodon.puyo.jp","wxw.cat","masto.namwen.me","pleroma.elinvention.ovh","social.acapi.net","sanguine.space","frenchindiepop.com","pleroma.p4g.club","peertube.mastodon.host","dmp.m.to","social.netzkombinat.su","social.bihlink.com","megaterio.org","capri.d5shottkcas.tokyo","sushi.ski","develop.gab.com","mastodon.jalgi.eus","sendero.social","toot-lab.reclaim.technology","yuzuki.m.to","mastodon.jim.bo","buildthatwallandmakeamericagreatagain.trumpislovetrumpis.life","fireglow.de","rivals.space","netherdon.nyadobe.online","zefirchik.xyz","sns.little-girl-float.in","mstdn.onl","pleroma2.miraiv.net","sungo.space","pleroma.io","mstdn.kessai-otaku.club","gorf.pub","mastodon.herrliberg.online","tmp-mstdn.cloud","mastodon.hakoai.com","social.justos.info","theicon.stream","social.lightlyseared.online","msky-5g.h3z.jp","brandenburg.social","pla.social","wifi.masto.host","internetstuff.xyz","ryanthomas.org","sakurapuare.tech","pleroma.antoineve.me","friendica.art3mis.de","lain.sh","friendica.opencloud.lu","walkers.social","edgerunner.network","mastodon.watkins.opentechnologies.co.za","gaybaby.club","search.fedi.app","shikokudon.m.to","izumyan.m.to","misskey.lunet.org","social.bankmann.name","masto.davewinter.info","misskey.nemonet.xyz","bay.ninja","rustedneuron.com","toot.sebastian-tobie.de","sozen.network","postdon.com","smallcamp.art","annaclemens.io","midnightride.rs","instance.business","springspin.nl","florianjensen.com","md.cryo.jp","mstdn.prfm.jp","duk.space","mastodon.jumanji.co","oortville.masto.host","social.chadwaltercummings.me","mastodon.ef67daisuki.club","mastodon.white-void.net","mstdn.pj-jp.net","lapuacase.info","mastodon.hamburg","meshed.cloud","pleasehug.me","foss.al","toot.rodeo","dolphin.boon.chat","crisismodel.com","kinky.business","mamut.social","casually.cat","makito.me","mistodon.cloud","spiral.sh","ofuton.io","pleroma.armpit.me","occult.camp","mi.zuiho.moe","amefur.asia","toot.la","nebula.moe","mas.korrigan.tech","1929.com","sowhappy.us","this.mouse.rocks","pleroma.apkfission.net","piratenpartei.social","provo.lol","fuckingweeb.moe","livelaughnude.com","det.social","sunrisesunset.shop","hiveway.net","raspidon2.mamemo.online","chilli.social","sylveon.club","yarr.io","mhp.singleuser.club","weeb.academy","uldhaar.dk","libertywoof.com","mytter.jp","olsenfam.masto.host","m.tkw.fm","mastodon.toeushimwk.work","s.neguse.net","whisper.tf","pleroma.jonquan.moe","mstdn.gtn-works.com","pleroma.sembei.net","social.lolcow.org","fedi.cc","welovela.in","dokasen.com","social.nothingplanet.com","fabis.cafe","tatmius.tk","freedomofpress.rocks","unitum.nl","friendica.me","mastodon.partecipa.digital","pleroma.breizh.me","pleroma.catgirl.biz","mastodon.9net.org","obousanmstdn.com","pachyder.me","pritter.work","write.tedomum.net","5dollah.click","backyard.cloud","va11hal.la","mastodon.fedja.fi","toot.computer","linguistik.ml","pleroma.voidlurker.net","plusone.live","social.hyuki.net","chemnitz.social","ehjovan.com","s10y.eu","pleroma.aksura.tk","dotopia.dk","m.chars.jp","social.henzi.org","brainvom.it","zowi.ee","mastodon.sylphid.jp","mstdn.niigata.jp","hentai.social","meinungsschubla.de","hive.institute","litterae.social","fedi.n0id.space","gochai.top","ican.codes","panoramabox.hostdon.ne.jp","boritsch.de","es.shitposter.club","pleroma.pixificial.xyz","mastodonperu.xyz","mei11.nem.one","mastodon.acc.sunet.se","pixie.town","mstdn.sanin.club","masto.kreks.nl","bereal.monster.hostdon.ne.jp","hakomas.cf","wurm.host","mst.ongstar.jp","freespeech.host","pleroma.amoonrabbit.reisen","pleroma.site","pleroma.distsn.org","smatodon.net","dym.sh","yasudon.jp","moment.ist","eatthebugs.social","0x2a.club","ideadon.net","o1li.net","pm.ernix.jp","tymoon.eu","preciouslittle.life","mastodon.possumlodge.me","d2l.masto.host","melonmancy.net","kettle.social","jonleibowitz.social","osomatsu.mastportal.info","accela.online","pogge.rs","fedi.valkyrie.world","community.scinan.science","gamestop.store","c3-mastodon.rkunkunr.com","majak.de","pleroma.nl","gdev.fedibird.com","mini.noellabo.jp","mast.adorsaz.ch","l.emon.party","dotdon.net","pleroma.cat","solarpunks.social","orb.an6.us","tukkers.online","sone.nrsk.no","popon.pptdn.jp","pokorny.ca","tutut.delire.party","unextro.net","social.super-niche.club","h-sund.nu","not.phrack.fyi","ursal.zone","unkomaker.net","pleroma.d3add3d.net","circlelinego.com","youkai.town","butts.team","nineties.cafe","pleroma.wakuwakup.net","m.aki-null.net","noisy.lexie.space","mingxingsex.com","jsonly.club","social.rob.in.net","barkshark.xyz","conf.tube","social.shadowfacts.net","seichi.work","yeeehaw.club","cryptodon.tokyo","testing.pleroma.lol","mstdn.kazu34.net","nshl.xyz","mstdn.japan-railway.tokyo","pleroma.gnusocial.club","summerlin.social","pirateradio.social","mastodon.danielmoch.com","herzbu.de","pyrosome.social","camixo.com","mastodon.yantou.co","schizoid.tech","social.wexlercommunications.com","social.hoga.fr","social.lainon.life","social.stardenver.de","mastodon.osyakasyama.me","greenpencil.social","socially.whimsic.al","visualsoul.uk","docker4.a9z.dev","f.xn--7s9hd.ws","wubrg.social","misskey.sc3.fun","social.here.blue","social.nixnet.services","mastodon.johndoe.gq","lunareclip.se","mastodon.odessen.com","don.tacostea.net","social.cool110.xyz","msk.nemonet.xyz","pleroma.yanlinaung.xyz","swiss.social","mstdn.vtube.media","masto.don.neso.tech","z.sv7.cc","pleroma.otter.sh","mastodon.nielsemmer.com","plm.ranranhome.info","antifagun.club","yume.social","patch.cx","kirby-fans.com","pleroma.inferencium.net","forever.lo-li.art","fedi.okaminet.xyz","sealion.club","scenecore.net","arkaic.com","mastodon.obspm.fr","social.bitstick.rip","uberspace.social","hdhdhd.m.to","mastodon.dowata.xyz","ourdiaspora.net","witchcraft.cafe","sns.gdgd.jp.net","hates.company","fediverse.cyou","orctavern.pub","kitsune.cafe","yang.social","ftb.masto.host","mk.aqr.af","cat.social","friendica.bdeshi.space","social.wxcafe.net","sadlads.com","vapers.jp","misskey-exp.cyberrex.jp","akanechan.love","sheithens.online","boberts.me","mstdn.5ch.pink","hashtag-relay.dtp-mstdn.jp","premium.m.to","social.fediz.one","aobuta.m.to","headphone.actor","pleroma.huttiesroow.nl","video.autizmo.xyz","pl.seedy.xyz","mastodon.ericbeckers.nl","pleroma.elementality.org","lurid.pink","opensocial.africa","lily.network","mstdn.ca","adstodon.com","trans.town","saturation.social","2.distsn.org","legbeard.xyz","pleroma.toot.koeln","magenta.click","maescool.be","cmd.social","lord.sh","loadaverage.org","social.nicolas-constant.com","skj.ca","pleroma.moeplebs.online","social.fifteen40.com","irrsinn.life","albin.social","raptol.net","mstdn.klg-tree.jp","pleroma.tyil.nl","mi.escapism.work","social.cobaltia.org","pl.telteltel.com","hub.somaton.com","my.brick.camp","programmer.technology","don.yohane.su","pleroma.kiwifarms.net","meisskey.nemonet.xyz","friendica.wprzemianie.pl","cbr-bubble.masto.host","sangha.social","social.beckmeyer.us","cofe.rocks","mstdn.at","meiso.m.to","m.tzyl.nl","mi.ebisu.me","moeplebs.online","mastodon.potproject.net","m.bonzoesc.net","mastodon.remben.ch","yoitsu.moe","memehub.eu","innerwebs.social","akitaken.m.to","woof.group","toot.juro.cloud","beer.m.to","snabeltann.no","social.city-of-glass.net","meow.zarchbox.fr","hispanilandia.net","tootme.ru","tomitodon.huideyeren.info","pdt.m.to","creature.cafe","climatejustice.rocks","mastodon.bi119ate5hxk.net","amicale.net","social.rb99.space","trapped.online","masto.posweg.es","dickshow.social","wtf.social","fissionator.com","mi.siotter.xyz","peertube.video","pleroma.cutiemiku.tk","pleroma.chiffon-sepxipl.com","social.evotm.com","pokeple.hostdon.ne.jp","tuusin.misono-ya.info","social.nyanlout.re","social.icynet.eu","fox.masto.host","kylepiira.com","stellaria.network","as60927.net","s-shinjuku-rail.hostdon.ne.jp","twitter.activitypub.actor","app.dopasoft.com","garakuta.online","mastodon.hackerlab.fr","mstdn.seibu-lions.love","floss.social","pleroma.freespeech.host","friendica.heikosblog.eu","mastodon.openpsychology.net","sandbox.skoji.jp","social.aidannyquist.com","zalluma.adef.xyz","aorinngo.tk","dica.interfel.de","toot.my","seetake.net","projectx.fun","unidon.asmodeus.red","aeronavis.felesitas.cloud","masto.technologyinmontreal.com","misskey.ne-moni.work","taroedon.com","justodon.net","mstdn.alicia.ne.jp","pleroma.cloud","pic.otos.red","bae.st","friendica.mrpetovan.com","nulled.red","cuteposting.institute","thehighlands.fyi","yharnam.singles","awoo.chown.me","x2592.com","blog.hidao.work","geyikatlasi.com","mstdn.seikin.club","jmm.kr","mir.hostdon.jp","mo-na.space","mi.cbrx.io","fri.nrsk.no","icedtux.no","cncs.io","begovoy.social","sweet.sugarcube.pw","terrible.place","prout.social","yutacar.info","bakitodon.com","dis-le.de","434.earth","mas.ggr.me","pleroma.usagi.top","yumisskey.net","another-guild.com","soc.h2x.us","toot.love","mochi.kaede.im","thechad.zone","mastodon.red","dev.ple.b-shock.org","kayii.goe.land","friendica.togart.de","undergamer.quest","colorid.es","mstdn.fm","osechin.co","pleroma.mnko.info","yumehaki.club","neo.hongeipii.com","siou.ga","orikilli.yaruki0.net","video.blender.org","social.fibercrafts.online","mstdn.lovelive.social","sns.xn--931a.moe","pornanime.club","manji.dev","mi-chan.work","2to2.xyz","5ma.club","boardgames.social","social.woefdram.nl","kag.social","mstdn.im-neko.net","ponies.im","xarxa.cloud","social.ttree.ch","blackflags.io","horche.demkontinuum.de","takeko.monster","fedi.fit","banana.matus.rocks","amemiya.work","social.dhbit.ca","qaf.men","mstdn-kanazawa.jp","momo.mame.moe","social.drastical.tech","shadowverdon.m.to","famichiki.com","robot.rodeo","cogitoergofem.me","334.ovh","dolphin.nemonet.xyz","smores.town","thraeryn.net","thewaifu.club","pforzelona.club","mastodon.vierkantor.com","bibeogaem.zone","fedi.vulpes.one","nkmi.cc","communick.com","1000dollars.info","bot.abyss.fun","mst.lin5.taruntarun.net","mastoden.com","poofion.com","pl.jeder.pl","kink.town","konfederacja.ru","activitypub.lacolaco.net","mst.idsdt.com","humanities.one","bugs.social","chabant.social","social.nah.re","oima.tech","yakiniku.m.to","megalodon.tokyo","mastodon.levome-dol.com","oinarisummer.xyz","machikadon.online","derpsin.space","mastodon.cardina1.red","santsenques.cat","mastodon.evolix.org","social.mark.atwood.name","morg.i.ng","machida.yokohama","social.hairydiode.xyz","moonbeam.dance","v112.space","nyquist.space","loli.estate","args.in","secure.kiwi","sebbo.net","music.glitch.pizza","programming.socks.town","www.xiaoyun.space","lain.com","famline.ru","elle.systems","upallnight.minnix.dev","secular-humanism.eu","shitpisscum.mooo.com","mastodon-sci.tk","mas.gordons.gen.nz","social.asgartech.com","nsfw.social","bangdream.tokyo","popradio.club","ore.m.to","fedispace.ml","misskey.rip","hpive.misskey.online","animal.church","wrestlr.social","blobturtle.club","tiksi.net","social.wefav.com","social.nasqueron.org","friendica.conscious-connection.de","awoo.fai.su","mastodon.derveni.org","social.sakamoto.gq","likeable.space","framapiaf.org","miraiverse.xyz","mikumiku3.masto.host","armisskey.nemonet.xyz","social.wells-family.xyz","snapp.social","ap.lollipopcloud.solutions","mast.eu.org","four-nine.club","don.mfz.jp","pl.at7s.me","mastodon.thepacket.exchange","playvicious.social","hunk.city","social.cologne","mstdn.tsukiyono.0am.jp","pleroma.damnx.net","lewd.website","mastodon.wearefamily.africa","ef67.myhome.cx","misskey.to","mastodon.latransition.org","lbry.world","social.randyr.xyz","wafflec.one","m-i.im","is.chaotic.moe","xiling.site","nr.akarinext.org","social.i2p.rocks","dehawara.de","digitan.ga","otherkin.club","hiroshimastdn.club","ansico.dk","lazer.pizza","networked.space","fedi.one","social.dmogle.com","sipassa.gq","one.telmina.com","take.iteasy.club","metalhead.club","ancr.club","friendica.acidflowermusic.dance","idf.social","social.culturewar.us","basictomonokai.m.to","masto.einzbern.one","nyan.cafe","mastodon.kasu.me","auntiefasupply.co","damogran.space","hakorena.net","testomat.singleuser.club","barrett.dog","mstdn.kaiz.jp","surfin.dog","st.curesta.b-shock.org","sjitter.com","fuckonthefirst.date","social.rudloff.pro","ekimemo.info","md.siru.tokyo","toot.moqueur.chat","booktoot.club","social.csswg.org","mstdn.yaesu-eas.tokyo","we.snap.as","ww1.mindblast.space","plaza.vaporpolis.net","msk.ruste.red","akko.kalasarn.se","apfed.club","dib-social.bewegung.jetzt","newjack.city","scuttlebug.space","animalliberation.social","gracchi.work","fedi.xaloc.space","social.putz.space","zotum.net","algonoise.social","pleroma.liveunix.org","soykaf.org","mu.zaitcev.nu","sabakan.masto.host","fla.red","refusal.biz","leaf.style","mk.freespeech.host","plrm.ddns.net","social.outsourcedmath.com","pleroma.soykaf.com","raggedfeathers.com","mstdn.fukuoka.jp","mastodon.gza.jp","holly.town","computerhater.club","iruka.usagi.top","pl.omaera.org","babic.dev","p.umbriel.fr","mstdn.jnsk.info","pleroma.kagura1050.tk","p.kokolor.es","scintilla.social","pl.deepzero.net","i.mi.xeltica.work","so.mctek.tk","masto.henchmonkey.org","social.poro.tokyo","soc.free-pic.org","pleroma.amas.dev","doesnt.undo.it","social.cshire.xyz","social.wieser.ml","mastodon.chaosfield.at","ylan.page","shitpost.poridge.club","mstdn.otyakai.xyz","transport.msky.cafe","moth.zone","social.boiledscript.com","www.chatalk.club","killmi.st","rud.life","ghetti.monster","mstdn.wiper.dev","libre.cx","hikarin.m.to","social.filipesm.com","inks.tedunangst.com","fursona.net","chickenfan.club","mstdn.precure.fun","mastodon.aquarla.net","cliterati.club","mas.korrigan.link","kcore.org","mastodon.atikoro.net","dcreager.net","bot.cofespace.com","fribygda.no","pleroma.unigiri.net","udon.red","mdx.k-easti.tk","firebreathingduck.io","radicchio.town","digineko.jp","talk.katafpv.ch","trans.enby.town","lasersword.club","tunamaguro-don.m.to","xin.cat","yakiniku.cloud","mastodon.geekzweb.com","mst.thewebzone.net","alirezahayati.com","pl.knotteye.cc","ninetails.click","toot.thoughtworks.com","grurple.org","mastodon.opencloud.lu","anisodon.jp","mentalhealth.social","pleroma.siina.wtf","tristram.uber.space","saku.kot.jp","gould.cx","mastodon.fidonet.io","nightis.land","plr.inferencium.net","masto.gaming.pizza","social.uhoreg.ca","glitch.librenet.co.za","yo.isurf.ca","pleroma.dragast.me","friendica.ucy.de","misskey.xianon.net","bullgit.party","ap.ketsuben.red","digineko.net","friendica.ungzeit.de","scambait.social","zap.dog","metro.bieszczady.pl","m1.cryo.jp","gts.cybre.ninja","robo.super-niche.club","friendica.os-service.eu","fed.fab.industries","pleroma.jeder.pl","mastodon.lrdf.fr","faithcollapsing.com","pl.quic.fr","blue.skye.cx","nu.federati.net","supersandro.de","social.nofftopia.com","pleroma.pierre-duchemin.fr","mastodon.home.js4.in","mastodon.zunda.ninja","glammr.us","embracing.space","mstdn.novium.pw","toot.kiez.xyz","mastodon-network.com","pleroma.arukascloud.io","livers.jp","olivianet.work","toot.playground.ws","word.builders","fedi.app","sunflowe.rs","pom02.top","kadokawadon.jp","pl.serialmay.link","mstdn.yukarin.love","ridethe.coffeesurge.com","heartlandia.live","capitalism.party","mstdn.ropo.jp","cbfish.es","petko.me","botdon.net","s.schieder.me","happyjesus.online","mirrored.social","mastoot.com","mstdn.a-tak.com","maoh.company","social.5ch4um1.es","dev.knzk.me","greenish.red","aytolis.mayvaneday.art","small.tiddy.city","mast.virtuallyhillbilly.com","toot.x2a.io","tropical-is.land","pl.n0id.space","occult-zuki.com","social.louisoft01.moe","mastodon.mikegerwitz.com","z.macgirvin.com","tears.intherain.club","ureteralstones.life","pleroma.neuromante.net","ltch.fr","pub.pm","mastodon.bug-fix.net","stable.strizhakov.dev","taek.us","melon.computer","mastodon.pdbq.us","msdn.yourrhythm.jp","social.beepboop.ga","ginju.de","moytura.org","arkham.cafe","social.excelereight.tk","libarti.com","pleroma.nethole.us","geekcompass.com","masto.1146.nohost.me","mstdn.yoshimov.com","mastodon.jpages.eu","mastodon.flifloo.fr","pennywise.m.to","boltcutter.network","voice.masto.host","seacow.social","mstdn.anqou.net","communicating.cypherpunk.observer","yeehaw.town","ffs.social","mares.cafe","mastodon.dergrimm.net","kohrville.net","fanfare.horse","gogel.social","pinkdog.cc","sad.cab","khajiit.tech","cipiosacg.masto.host","mastd.me","mastodon.org.uk","robertbrook.masto.host","ms.neko.bar","enby.club","doing.cute.science","feuerwehr.social","sonoko.syo.tokyo","mxin.org","m.upsilo.net","s.knusper-land.de","thefreestate.xyz","mastodon.cercle.jp","social.as","friendica.wapnitsky.com","p.bilb.info","eupublic.social","boss.taxi","s.mrxi.org","scalie.club","md.gloon.jp","schelling.pt","ifrit.gaia.ff14-mstdn.xyz","pleroma.crowesnest.io","social.atrilahiji.dev","deny.club","miniwa.moe","freeside.online","kuropen.me","mastodon.angrybj.com","social.linux.monster","onore.org","pixelfed.noellabo.jp","ministryofinternet.eu","mstdn.us","mstdn.yoshimov.info","solarpunk.moe","marf.space","ilex.nagoya","nx12.net","expo.gspot.social","tsuraine.net","fuzzy.systems","mastodonten.de","social.buffalomesh.net","catgirls.cafe","mastodon.zapashcanon.fr","mastodon.yantouer.com","asnas.m.to","verita84.com","ronin.world","mastodon2.juggler.jp","techie.family","social.zdx.fr","433.world","hullblasters.club","tooters.space","fediverse.one","hub.cats-home.net","mm.puni.moe","mastodon.cf","laplem.coolcool.ynh.fr","sale.gauchiste.club","chile.masto.host","ohnomy.rocks","toots.dgplug.org","eh5.me","mstdn.8mitsu.net","mstdn.camera","notvery.social","pl.snowii.moe","ippandon.hopto.org","deo.moe","indoverse.nl","devs.live","devin.masto.host","mstdn.soysoftware.net","pleroma.wolfie.pw","speakfree.world","stellas.cf","neko.st","gentle.town","delaeuforia.com","loftypancake.masto.host","don.taprix.org","social.koyu.space","eizi2002.orz.hm","eclesia.space","misskey.girak.net","beepboop.one","blurts.net","odin.run","mastodon.lcavallaro.com","vgai.de","social.senooken.jp","pleroma.agol.one","fnya.ggtea.org","mk.chocoflan.net","fuwa.pink","boseburo.ddns.net","m.uuu.moe","sneed.shop","sackheads.social","social.lo3.online","sneak.berlin","dain.moe","mk.niscii.xyz","social.satanic.coffee","mcrn.one","toot.supremesyntax.com","msky.ahokusa.club","nemoins.tk","keybored.me","kafuka.me","blaisemcrowly.com","t9.no","fetishdon.tk","spectres.space","phoxy.space","mstdn.aotake91.net","vocabar.net","vloggers.social","smilodon.tuxcrafting.cf","gecekafasi.com","mastodog.net","pleroma.yonkoudai.space","minus.haruk.in","friendica.zeitverschreib.de","pl.glie.town","wall.demouliere.eu","www.friendica.dupreez.id.au","mk.absturztau.be","tebukuro.pw","soc.z80.moe","prettyqueer.online","fedi.dananglin.me.uk","fedi.ajl.io","donotsearch.xyz","society.oftrolls.com","queerdorks.club","thetower.xyz","subcon.pub","social.gent","friends.noise.rocks","masto.quad.moe","toki.social","lahfa.fr","akitadon.info","pleroma.eigenellies.space","scarlet.house","wandzeitung.xyz","indyjp.club","wakakyu.tk","muensterland.social","tebukuro.m.to","mastodon.pluser.net","mastodon.im","quanta.wiki","awoo.space","edge.misskey.io","chilemasto.casa","pleroma.quaylessed.icu","duck.cafe","nukem.biz","polyamory.social","don.nekoport.com","pff.o.hina.dev","ifwo.eu","666.glitchwit.ch","mastodon.carbontwelve.jp","misskists.gq","m.puni.moe","mobile.st","drumbum42.com","fedi.farm","mastodon.mnetwork.co.kr","peertube.touhoppai.moe","dot.or.at","md.ggtea.org","toot.redmine.jp","mastodon.setsuna.kr","olds.town","cooler.mom","superseriousbusiness.org","fedimaker.space","nutt.church","fossium.space","rizomatica.org","mi.xn--931a.moe","re.kirishima.cloud","dissidents.social","tavern.cafe","status.pech.tech","connect.fshm.in","chowchow.social","icioulaba.tk","mastodon.mit.edu","nyon.marimo-net.com","enigmatic.observer","idlethumbs.social","mas.blackfireworkz.tech","social.ufeff.club","epitaph.noize.guru","sukadon.m.to","aban.don.neso.tech","netzkombin.at","go5.dev","don.neso.tech","mstd.toco2.fun","kinishinai.net","muknown.jp","doll.social","my.swiso.de","kaver.it","shalmirane.de","oneiris.me","now.kibousoft.co.jp","melonpan.run","schmu.se","social.herag.xyz","hexadon.net","julianjulian.moe","im.palon.org","sergal.org","darkyonmasto.ch","hirtzfr.eu","apple-user.club","testpl.wlw.pw","mastodon.schuerz.at","hi.technomancy.us","kliu.io","social.diskseven.com","mstdn-workers.com","social.device5.co.uk","social.odayacres.farm","social.technodruide.ca","privacymatters.pro","socialprivacy.network","fediverse.nenmyx.dev","friends.deko.cloud","ausglam.space","onster.farm","pleroma.pibvt.net","erica.hiyuki2578.net","gnosia.info","furry.pt","toepi.moe","kottman.xyz","travelpandas.fr","salmonella.tk","social.buckket.org","fakeologist.social","1tp.dpost.jp","pleroma.notbren.xyz","pleroma.guizzyordi.info","social.rjbastyr.com","thx.one","smeap.com","social.ucode.space","claristdon.link","kaiser.wang","faithklock.masto.host","social.dsmouse.net","hub.volse.no","social.bckr.me","transfurrmation.town","mammut.fsck.jp","pleroma.betamax65.de","social.qaq.wiki","veenus.art","tegedon.net","pleroma.hidao.work","decentralised.social","heavensfeel.xyz","www.pagans-online.com","u.johnconway.art","dolphin.nokotaro.work","gametech.masto.host","pleroma.mevo.xyz","social.rosnovsky.us","fedi.scd31.com","mastodon.linenoise.club","vnil.de","mastodon.esthetic.win","mastodon.izsak.dev","social.squug.net","cnet.site","psynergy.io","norimi.ch","comradical.net","social.kroo.is","pl.sns.onl","campfire.website","mochiwasadon.com","misskey.pantasystem.com","social.rbs.io","test3.syuilo.dev","mastodon.tojo.tokyo","comfyboy.club","socialcandan.ga","mastodon.mxhdr.net","mstdn.bmw-and-more.info","occult.institute","mastodon.shioyaki.party","horsecr.app","mastodon.acc.umu.se","social.isurf.ca","friends.cafe","pleroma.fun","chitose.moe","social.hikaruaikawa.com","vriska.life","meru-golang.jp","friendica.minecloud.ro","test.wlw.pw","jepsen.io","pleroma.zenwillow.website","cmx.im","haruhi-mstdn.club","mastodon.swordlogic.com","prismst.one","yakumo.tech","social.reinboar.xyz","based.social","plero.ma","mstdn.tinykitten.me","lardbucket.org","mcd.dk","unkomaker.info","stardew.city","xey.me","fedi.ruinouspowe.rs","corginet.duckdns.org","social.hunterjozwiak.com","anarchism.online","panthermodern.net","sitedethib.com","wuewuewue.de","v2.tamx.tk","pleroma.foederati.dk","hispatodon.club","social.anufrij.de","pleroma.nindanaoto.dev","friendl.y-y.li","jitakudon.com","mastodon.sardo.work","dev.noovi.org","www.chemoner.tokyo","gnosis.systems","futuregadgetlab.cc","mk.yunyun.moe","s.dat.cloud","waha.work","mstdn.mimikun.jp","breezy.my.to","pleroma.elyat.im","dcentralisedmedia.com","friendica.philipp.info","mastodon.esmevane.com","test_t_msk.m0.lc","play.bluecore.net","mastodon.libre-entreprise.com","freespeech.group","pouque.net","prsm.space","social.farhan.codes","social.brokenbydesign.org","topic-master.com","fedi.murky.club","pgh.masto.host","thicc.horse","mxh.life","misskey.t-asa2000.net","peertube.linuxrocks.online","mstdn.square-rooty.org","testing.lanodan.eu","social.dark-alexandr.net","blog.crazynewworld.net","gayrobot.club","bidule.menf.in","tcnfy.uk","zettelkasten.social","gs.smuglo.li","meinrheinma.in","wutup.wtfflorida.com","otajo.tk","ramses.amicidelbaretto.org","pl.koyu.space","stg.mstdn.plusminus.io","chat.cdstm.ch","catgirl.science","social.biologianaweb.com.br","mstdn.ebi-fry306.net","mastodon.anti-globalism.org","turtle.m.to","cute2d.moe","fellies.social","mastodon.baucum.me","mstdn.info","gspot.social","mandodon.com","cironnup.com","mstdn.ryanak.xyz","toot.berlin","mstdn.toad-in-the-hole.net","neetodon.com","ajnf.art","p.mr64.net","mstdn.kanagu.info","m.hxbus.net","mdx.ggtea.org","mastodon.noraworld.com","necko.plala.jp","mastodon.triggerphra.se","zomglol.wtf","pawoo.noellabo.jp","devfs.xyz","mstdn.amas.dev","misskey.nenohi.net","glaceon.social","framatube.org","mastodon.pirati.cz","masto.technology","posting.lolicon.rocks","utopia.cool","melmc.nohost.me","mastodon2.gnudoux.org.ve","social.vengeful.eu","zhenyabot.m.to","cloutfla.re","kuko.hamburg","justicewarrior.social","broadcast.looplab.net","convenient.email","cypher.social","mastodon.wurzelmann.at","toot.coupou.fr","pi.soykaf.com","mastodon.greenpeace.ch","mastodon.alexkeating.me","bots.tinysubversions.com","elephant.bike","pleroma.freespeech.club","guchitter.m.to","pleroma.elizafox.space","f.l4.pm","aomoridon.m.to","mediartodon.net","mastofant.de","hakobe.masto.host","kurosawa-ruby.xyz","social.3cat.icu","edge.taruntarun.net","culturewar.site","puzzl.hostdon.ne.jp","globalwarming.fun","syasai.club","social.tachibana-labs.online","testdon-home.layer0.dev","social.ascendtoday.link","social.elomatreb.eu","social.cyano.at","mastodon.fedi.quebec","crypto-group-buy.com","plrm.onigiridon.com","hitchhiker.social","toot.ebc.li","ariadne.space","mstdn.onosendai.jp","social.clttr.info","pleroma.heavensfeel.xyz","fedi.toniotti.be","social.illegalpornography.com","rbq.social","femboy.city","lsngl.us","pl.kpherox.dev","social.arqadium.com","tootplanet.space","glindr.org","mstdn.cygnan.com","social.garwood.io","alongtheray.social","social.thman.ovh","favela.world","mikado-city.jp","pl.cofe.party","mastodon.etalab.gouv.fr","godforsaken.website","one.darnell.one","social.yl.ms","akanechan.world","sivokon.me","misskey.usuyuki.net","pl.secretsealing.club","mastodon.org.ua","ykzts.technology","inkweb.network","galax.be","horsemans.online","ancientoch.info","c.ggc-project.de","social.fab-l3.org","rssfeedon.m.to","p.mailchar.com","v2.nyoki.club","blog.fedimast.com","p.cyberdelia.space","spacepub.space","social.nico-bayati.de","mastodon.cool","don.8mitsu.net","friendica.ironbug.org","social.mochi.academy","mastodon.codeplumbers.eu","higgs.boson.blue","md.net-p.org","social.stacktrace.sh","redwombat.social","ghost.cafe","meis.space","oseka.xyz","mastodonlist.com","mastodon.to","simkey.net","relict.one","pleroma-in.ouda.space","multiple-creature.party","social.0ko.me","ljoonal.xyz","trpg.cloud","homexlab.zapto.org","bostonmusic.online","csdisaster.club","mond-basis.eu","happylittle.cloudns.cc","vulpes.work","mstdn.glorificatio.org","divad.xyz","social.mofu2charger-listenradio.net","claristdon.net","pleroma.knzk.me","mastodon.juggler.jp","pl.nulled.red","pleroma.us","kaiserslautern.chat","pleroma.lord.re","xn--zck4ad5f2e.xn--q9jyb4c","sio.masto.host","social.patologia.online","death.horse","ernesto.dev","mastodon.com.tr","sldon.jp","0x3c.pl","emacsen.net","seal.cafe","social.taker.fr","pl.zombiecats.run","social.freetalklive.com","peoplemaking.games","acc4e.com","elysian.city","social.mootech.eu","tassaron.com","social.codeplumbers.eu","mastodon.ondergrond.org","is.tuxcrafting.online","mstdn.blue","khat.komitea.fi","tabletop.social","shiny.gift","phx.social","pleroma.aspie.freemyip.com","jaeger.website","pub.tryliberty.org","mauve.m.to","ec2.a9z.dev","ajin.la","mastodon.kosebamse.com","volunteer.zho.pa","ertona.net","sn.codem.xyz","carma.red","social.hemmnet.de","social.harshadsharma.com","p.kvche.ch","nitiasa.com","vietmojo.space","www.mofgao.space","hubzilla.l-p-d.org","itame.m.to","mastodon.luglufa.com","royal.crablettesare.life","mastodon.nagaseyami.com","bruder.space","pleroma.debian.social","video-cave.de","friendface.fail","misskey.wcdi.tech","plock.social","glitchcity.cc","jvpiter.net","music.lovers.town","plrm.moe.hm","mstdn.msky.tokyo","don.gomasy.jp","bot.undernet.uy","social.newbase.cloud","dramaless.co.uk","toot.place","mini.gorone.xyz","okadon.m.to","extremelywoke.club","mastodon.lertsenem.com","wokka.be","gab.com","mastodon.peterbabic.dev","mastodon.multimob.be","cryptids.online","spiderden.net","hodapp.club","hypno.church","idw.zone","rcj.mstdon.app","raki.social","fedi.xerz.one","commons.undergrowth-feed.net","social.dropbear.xyz","mastodon.syntik.fr","jank.town","ohhi.icu","mstdn.misosi.ru","blackrock.city","mblg.hiromi-mi.jp","digixp.dip.jp","mastodon.fediverso.net","impeccable.social","mastodon.falktx.com","researchbuzz.masto.host","2chan.online","wrestle.town","masto.svnet.fr","pleroma.prolatio.xyz","code4lib.social","cornerof.world","soc1.leftic.club","dotdon.jp","catgirls.love","sabowl.m.to","fedi.aurcanius.org","queertube.org","cold.solar","radical.town","social.walamana.de","park.hrsm.jp","queer.chat","pl.savant.so","desu.social","opantu.jp","blog.writefreely.org","wintermute.fr.to","mast.linuxgamecast.com","natudon-outdoor.net","m.jlelse.blog","mstdn.su","terusid.com","mikumikudance.cloud","unipar.online","status.akionux.net","psh.now.sh","liberal.city","pl.nudie.social","elefant.social","exited.eu","friendica.offsite.guru","queer.cloud","resistance.social","pl.hecke.rs","mastodon.tto.moe","sccn.club","tanavega.xyz","movsb.0x0.st","mstdn.frozenutopia.net","nyan.network","monsterprom.space","social.petrovs.info","freeneckbeardextremist.xyz","qua.name","mstdn.mini4wd-engineer.com","gomame.work","antama.m.to","social.freegamedev.net","boiskokoro.club","jeli.kz","social.ctu.cx","isometry.black","daedal.io","social.qseco.fr","point.community","support.m.to","social.famille-link.fr","1m.cutls.com","pouet.panglossoft.fr","pler.spearman.xyz","thewallsofnight.com","eigenmagic.net","blessedgeeks.social","magikarp.fun","flumph.masto.host","artalley.porn","cocoronavi.com","connected.cat6.network","share.elouworld.org","makerdon.org","catgirl.life","illyasviel.cf","aobuta.yokohama","mastodon.reyuzenfold.com","social.libre.fi","toot.life","imi.moe","hiroshimastodon.red","pleroma.phicode.de","lastfree.space","mastodon.3fx.ch","pl.sina.moe","the.shitposting.network","freethinkers.lgbt","humblr.social","mastodon.konstanz-net.de","thejoyo.com","pl.che5hire.club","cum.desupost.soy","sea.soundship.de","yuzulia.xyz","rukin.me","misskey.wine","unitquamus.herokuapp.com","websozis.social","akkoma.eniehack.net","sumikko.club","loves.family","xyag.space","masto.themimitoof.fr","splat.soy","social.incorrect.space","amsterdon.nl","occitanie.social","cyrenesavage.com","beta.koyu.space","touha.me","friend.camp","mastodon.lazysquirrel.co.uk","mastodon.haus","erikxxon.se","mastodon.wildwildwestcountry.uk","moe-overload.com","social.tigwali.fr","restart.moe","naz.vc","member.thenobody.club","my.elven.pw","mastodon.codingfield.com","salted.fish","mdon.ee","fikaverse.club","social.yakshed.org","momoiro9.ro","tooter.selfhosting.rocks","piss.restaurant","gab.polaris-1.work","pl.libre-association.party","republic.norrland.xyz","mstdn.lalafell.org","pleroma.ryusei.dev","cute2d.love","darui.work","f.nospy.net","mt.onigiridon.com","si4-mstdn.xyz","kaiba.ga","sigint.sx","gudeleu.de","resetbomb.viridiome.ga","mstdn-5g.h3z.jp","pl.lifeweb.cc","definitely-not-archivefedifor.fun","nekoscience.space","demon.social","md.yutasan.co","weedis.life","toot.lmorchard.com","msky-ng.h3z.jp","suspended.club","social.captainark.net","nangang.travnewmatic.com","akitadon.com","mastodon.toycode.com","dev.mstdn-jp.site","monocles.social","interconnected.systems","fedi.site","anime.mstdn.cloud","bobadon.rocks","pixfed.korrigan.tech","mastodon.artritelacy.jp","pleroma.868center.space","mmorpg.social","social.rights.ninja","dogeposting.social","sarcasm.stream","toots.benpro.fr","antisocial.darkgeek.com","hoge-poyo.moe","pleroma.foxfam.club","chin-co-ne.co","catdog.me","zetsubou.xn--q9jyb4c","semisol.net","hulvr.com","ofuton.life","jabberwocky.moe","social.wolfskaempf.de","hostsharing.coop","pl.i2p.rocks","rainyman.jp","openweb.social","fed.jankambo.net","7td.org","e.usagi.top","ostatus.yoh2.ddo.jp","naturism.social","616.one","hom.ph","mastodon.lang-mfr.de","mostodon.cloud","mastodon.melin.org","eegle.cloud","speakitfree.com","deprecastan.com","erm67.dynu.net","pl.lain.bar","mirror.notreally.info","cat.family","social.broers.me","friendica.bachgau.social","mk.n0id.space","mastodon.city","schoolforafrica.org","hentai.press","karagedon.com","eattherich.club","mastodon.madrid","pl.2xx04.xyz","social.darks.fr","systerserver.town","pleroma.thick.rocks","schykle.com","social.mjd.id.au","blog.xeltica.work","geeks.cafe","misskey.poya.icu","retro.pizza","pl.cutiemiku.tk","social.art-software.fr","social.ppmx.org","microblog.r-12.net","norze.world","mastodon.room409.xyz","yukari.cafe","mastodon.hsablonniere.com","kinkyelephant.com","mastodon.education","chaosphere.hostdon.jp","crazylab.online","tube.kockatoo.org","44.ci","anarchydica.net","mspsocial.net","yiff.life","btw.no","fika.pleromazela.world","torti8.hostdon.ne.jp","mastodong.lol","tmp.nombi.link","lohn.in","social.anoxinon.de","traboone.com","melonbread.dev","masto.sahilister.in","fika.grin.hu","net4sw.com","hubzilla.com.br","termoyer.uber.space","starflower.space","social.plantcm.com","zee.li","bachgau.social","mastodon.techandmemes.dynip.online","lesbian.solutions","imaginair.es","remerge.net","wf.juggler.jp","4qq.org","pztrn.online","kanatan.club","heckers.org","social.fedcast.ch","social.rootaccess.org","oulipo.social","paquita.masto.host","fedi.ml","soziale.cloud","the.vermonters.club","misskey.fig.lt","rubber.social","piggo.space","pieville.net","sneed.vip","mastodon.librelabucm.org","idiomdrottning.org","gyutte.site","recurse.social","kirakiratter.com","leftism.su","pleroma.wafflec.one","social.k1ppl.com","cthulhu.social","azurlane.mastportal.info","everywhereforever.net","social.alesan.io","fedi.tsukura.net","nova.community","monsterfuckers.online","poya.icu","metacode.biz","pleroma.shitnexus.party","mastodos.com","fluff.land","darknedgy.net","shampoo.moe","clar.ke","sociala.me","gp.tsukimi.club","misskey.id","f.stp.cx","prolinos.social","nocserv.de","terse.telent.net","honk.vedetta.com","social.avareborn.de","ple.korako.me","masto.mtcrew.org","ahhhhhh.social","c2.a9z.dev","mk.vulpes.one","misskey.belligerence.club","bub.cat","juick.com","social.binarydad.com","ostatus.ikeji.ma","librosphere.fr","zecircle.xyz","toot.kuba-orlik.name","federate.hopto.org","pleroma.libretux.com","0x10a9b.pw","misskey.nokotaro.work","sanguinem.space","toot.masto.host","social.bobcall.me","banjo.town","mzn-potatochips.me","mk.iaia.moe","social.eyluldogruel.com","p.ashiato45.net","nichijou.dev","dansu.org","zetamu.love","friendica.charla.mx","rxtx.nl","lonely.town","river.divineduty.xyz","fediversekey.com","bitacadie.com","necropolis.online","social.tepitus.de","1234.as","mastodont.cat","is-a.cat","mstdn.nicolog.jp","pirate.chat","glitch.taks.garden","free.burningpixel.net","status.notcraig.com","kozlovsky.institute","expired.mentality.rip","social.kabi.tk","stonerkitty.monster","plagu.ee","fedimovie.com","rebased.io","jigglypuff.club","poopy.social","www.5dollah.click","coconatsu.co","social.otmns.net","mastodon.shelldog.de","myloko.xyz","friends.daspr.io","bulge.exposed","social.skazki.fr","pleroma.marussy.com","toot.tantalum.life","frica.frndc.de","social.edzilla.info","enitor.xyz","social.maltech.io","toot.kartonrad.de","feed.casually.cat","nederland.social","social.0x80.org","social.famidup.fr","writeout.ink","jorts.online","social.cigliola.com","wah.gg","dev.worst-friends.chat","pl.nemonet.xyz","p.qrbt.ch","social.hannebrook.info","tsia.de","friendica.poppelreuter.de","social.cosnomi.com","port53.me","mstdn.superspeed-fall.com","f.matri.ml","mstdn.fuyumori.net","mastodon.duncanhart.com","shpposter.club","federation.p1k3.com","refactorcamp.org","epiktistes.com","rosehip.moe","masto.galooph.com","x61.uk","glitterkitten.co.uk","hanisanchi.masto.host","pleromazela.world","masto.fdlibre.eu","asimon.org","n-msk-exp.stesan.dev","xindejiayuan.com","frennet.link","club.mrzan.xyz","alltomorrows.party","mstdn.xpub.one","pleroma.karjalazet.se","ocf.berkeley.edu","mstdn.i-red.info","from-arctic.net","fed.zmach1n3.com","oyd.social","friendica.astatu.berlin","astronomy.social","oc.todon.fr","elves.forsale","msky.3t0kb.com","misskey.xiling.site","mastodon.gsugambit.com","fedi.kloetensecurity.com","friendica.iworkinpixels.com","toot.ninja","social.sponheimer.com","newsie.social","pl.snootbooping.date","skj.social","sts.lqt.moe","pasta.ga","skippers-bin.com","velocipederider.com","mastodon.motcha.tech","plustodon.net","pixelfed.de","eletusk.club","guerilla-economist.eu.org","talkopol.is","mastodon.tedomum.net","mstdn.maud.io","plume.seediqbale.xyz","witchcraft.0j0.jp","mstdn.foxfam.club","berlin.social","bne.social","social.tinfoil-hat.net","toot.fedilab.app","crime.cafe","uzomuzo.work","misskey.oyster.red","ondergrond.org","mastodon-belgium.be","mastodon.anzui.dev","social.jlamothe.net","mastodon.moistgarbage.info","hakorena.hostdon.ne.jp","h-y-p-e-r.space","glitch.social","mstdn.f72u.net","mastodon.my-wan.de","gochisou.dev","39sounds.net","mk.wolfie.pw","mastodon.utwente.nl","bulbulator.net","social.4f9e1738.ignorelist.com","fedi.lightnovel-dungeon.de","mb.a-ef.org","fri.aethercom.de","caitsith.masto.host","social.wenzlik.net","lp.f5.si","kuluary.c44.pl","ovo.st","syntheti.cyou","hofra.rocks","dads.cool","pl.aljadra.xyz","serpentines.social","misskey.gothloli.club","pl.seahorse.sh","assemblag.es","misskey.tech","social.lxsameer.com","curenoize.org","skorpil.cz","pirati.ca","thechairman.info","sn.koi.moe","friendica.nz","kokonect.link","tomo.airen-no-jikken.icu","skull.website","morse.social","makimaki.jp","plume.xn--krsgw--n73t.com","fediverse.xavin.net","soc.burger.rodeo","badly.co","z0ne.social","social.seattle.wa.us","mastodon.savvy.ch","mastodon.linuxbox.ninja","autrechose.club","mastodon.nara.jp","updog.no","bimmer.social","electricpea.ch","beep.jae.fi","kawaii.kitsune.cafe","psipsistar.com","sua.anarkis.net","mathstodon.xyz","exile.social","williamsonday.buzz","social.nokes.name","huby.infozoo.de","friendica.blogsquad.org","zhub.link","gamerr.cyou","friendica.gidikroon.eu","akko.disqordia.space","is.aaronbsmith.com","pl.yarashee.net","social.lansky.name","social.urspringer.de","social.metrix.network","nijimiss.moe","mastodon.hugopoi.net","social.sp-codes.de","podworko.fidura.waw.pl","xn--69a.xn--99axc.xn--y9a3aq","fediverse-lite.com","bsd.network","512.moe","mastodon.oi7.de","freiburg.social","tenforward.social","swj.io","gulp.cafe","mstdn.misoni.me","mastodon.fedi.bzh","social.tcit.fr","comm.network","tusooa.xyz","epicyon.libreserver.org","misskey.xn--tmp-qb4b9c2eyc.tokyo","collec.tf","purpleforest.social","toot.site","gup.pe","unstable.icu","iam.lydi.as","1.7z.pm","loves.pizza","pl.veryamt.com","omg-anime-tiddies.i2p.rocks","alcatir.com","f.freinetz.ch","niggers.auction","pl.wizards.zone","connect.casually.cat","my0.net","lgbtqia.is","yysk.icu","diceyslafayette.r-o-o-t.net","tzcafe.com","thecroft.xyz","kitty.social","mastd.racing","mego.bar","pixelfed.sdf.org","isesh.com","chanyukming.com","mstdn.cloud.themaymeow.com","magnificentbeardsfan.club","pleroma.com","mitra.social","zeonet.xyz","soc.umrath.net","deepnexus.link","gazouiller.fr","proyectozero.org","storo.social","social.teci.world","social.fpvogel.com","writefreely.randomsoft.com","psimon.world","dettoxx.com","personaljournal.ca","hayu.sh","innocent.yukimochi.io","paxation.info","plerodatech.fr","peertube.su","tweety.icu","my.medic.cafe","pod.appliedmachine.app","soc.cattube.org","eskate.world","catgram.jp","comfey.club","nrkn.fr","gp.chillout.chat","anonsys.net","dystopian.space","encryptionin.space","taprlight.com","orenoshiro.site","www.mstddntfdn.online","howflatisthe.earth","rawr-xd.club","social.plaxon.de","blumpus.com","queer.af","sanantonio.lol","mastodon.neophili.ac","squeet.me","friendica.ru","krems.social","mstdn.asterism.xyz","pl.cum.makeup","pyon.social","peer.galaxycrow.de","miruku.cafe","tyazzkey.work","social.caa-ins.org","twooter.me","masto.therealblue.de","xxxtumblr.org","fediverse.blog","social.geekzweb.com","soc.kouett.net.eu.org","mstdn.cute2d.website","sf.social","is.nota.live","pleroma.kemonine.info","pleroma.jamesp.org","area51.tinfoil-hat.net","mstdn-jp.site","rpi.limited.systems","muenster.im","simian.rodeo","spokaneartcollective.com","hub.hayfidelity.de","mk.striker.net.eu.org","pu.akirin.xyz","ferrus.net","forum.friendi.ca","slumpedoverkeyboarddead.com","thepit.social","mk.cybre.ninja","akademienl.social","friends.grishka.me","mastodon.business","aether.re","trailblazer.social","m.nebula.moe","my.dirtyhobby.xyz","lavraievie.social","goatdaddy.net","mstdn.taiha.net","mastodon.insert.tk","ikbenpiraat.nl","mastodooooooon.xyz","trollian.space","xn--49ap3c.xn--y9a3aq","dp.massmist.net","bajax.us","blueadair.net","mastodon.hydrosaas.com","mstdn.b-shock.org","social.theliturgists.com","social.lnk.co.ua","mastodon.acerbo.me","beg.plead.help","lowkey.party","pleroma.popolon.org","toot.liw.fi","open.audio","cloud.karagory.com","mastodon.gurubert.de","yeahnahcunt.club","friends.devinemarsa.com","blog.serverok.pl","deadredterm.ddns.net","mirr0r.city","tiny-pillowfort.floating-in.space","love.alicecomplex.com","bitfudge.com","eupolicy.social","scalie.business","socialserver.science","wolfhowl.me","pixel.fk.ms","kcl.academy","mastodon.cosmicanimal.jp","pleroma.bubbletea.dev","inari.opencocon.org","sciencemastodon.com","nolineage.com","pleroma.newatlantis.xyz","club-house.work","twista.283.cloud","mammoth.social","janogdon.net","pleroma.les-requin.net","twitiverse.com","pao.moe","talkabout.cf","hodltech.com","interact.bluecore.net","lobby.currentpllc.com","pouet.fedisphere.net","tabletop.vip","kakafe.ga","social.eutychia.org","social.skrep.in","mastodon.morgiano.it","petertodd.org","masto.dotsod.com","neo.gyara.moe","jojo.singleuser.club","beta.birdsite.live","coopertronic.ddns.net","yasaiseikatsu.net","dev.real-life.social","masto.wayde.tech","toot.koeln","aspiechattr.me","not.acu.lt","alt.suicide.holiday","fnordon.de","cyberspace.club","fd.inggrismantap.my.id","social.saarland","m6n.onsen.tech","microblog.wiwie.dk","ibicadi.com","zoinks.one","blessedgeeks.org","harbour.cafe","social.anchel.nl","mastodon.macsnet.cz","mk.comfysnug.space","plzpet.dog","macgirvin.com","8080-kumquat-crow-nyflvcmo.ws-us13.gitpod.io","weeaboo.space","sn.angry.im","shitposter.club","ubuntu.buzz","write.curenoize.org","fedimon.uk","lanuevebastarda.es","friendica.feneas.org","social.nekover.se","write.privacytools.io","nya.one","friendica.pitichampi.fr","masto.cafe","ika.queloud.net","himk.am","mastodon.tetaneutral.net","mastodon.ml","persadon.com","social.masto.host","stray.shee.pink","pl.kurusukono.cc","vis.social","toot.feurious.com","solaris.institute","mdn.keasti.net","nahe.social","real-escape.jp","mastodon.nagoya","hackerdrinks.social","dudu.capricom.info","qdon.space","mstdn.traction.jp","mastodon.indie.host","io.pace.rip","social.raindev.org","yuukosan.xyz","blombus.com","hyan.ink","mastodon.blake-hofer.net","cybre.town","videos.lukesmith.xyz","mstdn.sigatu.com","elsmussols.net","social.lovingexpressions.net","p.cjqx.xyz","don.nekocross.xyz","blogs.kitaitimakoto.net","socialtruth.social","shelter.moe","finotto.social","we.1being.org","pesso.al","pleroma.estwald.icu","social.gl-como.it","slashine.onl","friends.wimmer-edv.de","madost.one","test.fedi.moe","petronel.info","rhabarberbarbara.bar","dorijan.io","friendica.actrophp.de","9kb.me","elijahs.space","social.scribblers.club","pixelfed.cafe","social.winter.ink","misskey.goochiegoo.net","mastodon.miku2go.com","vance.land","myco.social","p.tkw.fm","jeffery.singleuser.club","miss-myhouse-key.net","pl.m0r016.net","fedposting.org","gorf.space","umastodon.net","jauntygoat.net","stargaze.cafe","misky.rikunagiweb.jp","muute.club","the-idw.com","social.wercx.net","youdabomb.social","mastodon.jcx.se","friendica.lt","systematic.love","flanintheface.com","catspace.xyz","social.vandl.club","dsocialize.net","outrider.xyz","rumbly.net","immermusik.de","embassy.social","status.p1ng0ut.social","links.potsda.mn","mastodon.brodi.space","comradesonly.duckdns.org","girak.net","misskey.traction.jp","nagoyadon.jp","mastodon.icu","tekkadon.manimani.cc","social.makerforums.info","mastodon.gramschladen.de","sasuke.social","goyim.app","neue.city","flm9.me","social.snowcode.ovh","mstdn.cc","uhouho.xyz","nerdtreff.it","kodlomrazi.ru","misskey.sylph.space","nullwhere.social","rcsocial.net","8080-gold-tarsier-fnsbgb2h.ws-us03.gitpod.io","mastodonspain.masto.host","social.tofu.kim","mastodon.0xf4240.bid","panthermoderns.org","bgme.me","klee-wife.moe","sciences.social","social.inex.rocks","scoopgang.social","boskovice.social","dev.fedibird.com","z.kvche.ch","friend.town","cafe.chillout.chat","atolla.xyz","grandma.space","alvogue.com","livellosegreto.it","demozumpa.cz","pleroma.solwer.xyz","mstd.dansmonorage.blue","fedi.nekojanai.xyz","tane.codes","ru.social","mk.nixnet.social","toot.cat","misskey.azunyan.jp","pullopen.xyz","friendica.steampunk.social","mastodon.quantumindigo.org","void.brechanegra.net","ncc1701e.social","social.jmueller.eu","a.gawlinski.com","people.kernel.org","bigshoulders.city","slum.cloud","xn--69aa8bzb.xn--y9a3aq","fluf.club","kotakuinaction.org","starry.ml","coon.town","social.b10m.net","honk.worst-friends.chat","pleroma.noellabo.jp","pl.hrt.pw","b.koa.im","mindset.rage.lol","foundation.fedi.live","ti.akirin.xyz","spekta.culair.nl","coales.co","bittube.social","unimatrix0.is","mst.canor.kr","misskey.haibala.com","2nd.slum.cloud","groyper.world","hug.fedi.live","trioworld.fedi.live","think.freespeech.institute","haecksen.social","social.levelxstudios.org","inkwell.space","tube.tardis.world","libre.video","m.moec.top","plero.sirward.com","tenshi.sh","openbiblio.social","sns-sakura.jp","pleroma.potatoxel.org","va-11-hall-a.cafe","sartorial.online","pleroma.levome-dol.com","boosterfive.com","mstdn.home.neso.tech","mstdn.kirimasharo.org","h5q.net","social.namachan10777.dev","libido.pictures","lekker.page","ischool.social","social.doma.dev","blog.remark.as","digital.kame.land","loliheaven.net","nerdynate.app","msk.hoshisaki-h.com","toad.blue","angrytoday.com","c4.social","social.tadzik.net","pixel.tchncs.de","nishimin.net","ting.cm","x.palepanda.com","leroma.shrieker.net","sayit.world","tardis.world","metalbanana.net","mstdn.neria.link","bouvardia.icu","rebelbase.site","multiverse.fedi.live","mastodon.someotherguy.xyz","flownative.social","social.kuester7.com","m.gretaoto.ca","chancellor.social","social.nettek.at","social.theaugusts.net","shiina-rimo.cafe","lush.moe","blimey.social","mimumedon.com","social.076.ne.jp","nazi.social","friendica.ambag.es","radiosocial.de","mtn.ddnss.eu","mk.catala.digital","kemonodon.club","pleroma.salastil.com","soapbox.hostdon.jp","herboriste.portaesgnos.org","ftp.rip","bub.waifuism.life","peertube.xwiki.com","sns.iwata.love","gensokyo.social","bihlink.com","cunny.finance","mss.cgnat.net","tooter.social","lemmy.ml","dragonscave.space","gamelinks007.net","fed.thecyberdeck.xyz","mastodon.tonywebster.com","pl.anjara.eu","oran.ski","toot.yukimochi.jp","antinetzwerk.de","social.danksquad.org","nekomimi.yokohama","nca.aqualitore-lily.com","misskey.u0conveni.club","friendica.argentwolf.org","enju.grmnlc.de","misskey.estwald.icu","mastodon.bermuda-delta.com","unholy-lair.69.mu","www.loganjohndarylgraham.xyz","mk.xiupos.net","social.c-r-t.tk","hellquist.eu","machines.social","animeabyss.xyz","fediscience.org","fishingblog.org","liber.chocoflan.net","bareisyo.ml","social.kjv.online","p.oshiteku.app","kakeraverse.xyz","outpoa.st","mstdn.schoolidol.club","mathtod.online","noagendatube.com","pleroma.fedi.bub.org","mastodon.fam-ribbers.com","werebeast.io","friendsend.org","fedi.lynnesbian.space","mstdn.xn--h1ahnbk7d.xn--p1ai","la1.jp","pedo.school","nvdc.eu","comfy.social","inori.im","summoners-riftodon.jp","dindon.one","www.i-kaohsiung.com","palepanda.club","mastodon.ar.al","glitterforest.xyz","social.kinl.gq","gla.fit","pl.moth.monster","ni.hil.ist","anmol.net.in","mastodontech.de","ppl.town","tokamstdn.jp","booba.bar","social.timespiral.co.jp","mastodon.kleph.eu","mk.samtherapy.xyz","misskey.spartanserver.org","digitan.cf","www.nekotodon.com","social.gitea.io","beta.kokonect.link","social.franssen.xyz","nursing-home.334.ovh","nooble.cloud","pl.panoply.cx","friendica.a-zwenkau.de","meisskey.one","toot.martyn.berlin","social.qrbt.ch","louis-c-novel.com","biscuit.town","tfwnogf.nl","bildung.social","xn--p1abe3d.xn--80asehdb","pleroma.1d4.us","404.inexist.club","earthclub.one","unclealbie.com","port.mk","social.nilles.net","mastodon.mg","lewd.network","masto.jews.international","electric.glowing.surf","social.livid.pw","h.kokuda.org","social.ignifi.me","videos.pair2jeux.tube","atwab.ca","blog.hansenpartnership.com","m.smto.pw","worst-friends.chat","mastodon.yeetpc.com","social.ariona.fr","eigadon.net","pixelfed.uno","p.helene.moe","m.motisn.net","www.banepo.st","civil.rayn.bo","social.bemrose.us","mstdn.rinsuki.net","nymwars.org","social.prometheus.systems","pl.tkammer.de","mastodon.inferencium.net","widerweb.org","girlslove.pink","discloud.one","honk.tenshicorn.dog","m.hoshisaki-h.com","social.igwigg.space","incidentally.social","poly.cybre.city","hub.libranet.de","verified.af","pleroma.raite.social","social.cyberia.institute","lain.gay","conan.ooo","justabit.social","m.dogcraft.cn","columbia.mast.city","social.manzilalnabat.de","getindor.com","cuties.social","misskey.mydns.jp","cyberforest.xyz","goblin.camp","misskey.seediqbale.xyz","masto.nogafam.es","social.futurnumerique.com","universeodon.com","foxocube.xyz","notnow.dev","botsin.space","friendica.ellih.eu","esperanto.masto.host","degenerates.fail","xn--y9a6bah4ck.xn--y9a3aq","peertube.public.cat","topteeth.xyz","pleroma.tilde.zone","don.ffnet.work","sleeping.town","voring.me","nixos.paris","misskey.lol","misskey.naiw.jp","pl.neko.bar","fumisskey.com","entomophagy.world","etiketi.de","debiru.xyz","ski.na2na.website","gp4.nem.one","kurage.cc","umbrella.cafe","fedi.club","rn.akarinext.org","ilnk.info","ramen-fsm.eu.org","social.anartist.org","mastodon.poggersinc.com","aorinngo.ga","critica.social","social.orito-itsuki.net","socl.bz","social.katyucha.ovh","mstdn.vandrare.page","sinblr.com","social.eden.one","simonwillison.net","verr.cc","mastodon.gougere.fr","plume.korako.me","pl.spiderden.net","misskey.na2na.dev","runstop.org","hax.technology","wei.mentalswarf.com","skinnyver.se","pleroma.mouse.services","rainbowcolor.online","bbbdn.jp","u8.is","plume.atsuchan.page","pythondevs.social","xarxamontgri.masto.host","mk.hikali.work","cassone.social","social.network.europa.eu","social.thisisjoes.site","silkhe.art","monado.ren","hub.chibatsu.net","reco.shrieker.net","dajiaweibo.com","wut.m0r016.net","campfollow.life","greatview.video","friendica.verya.pe","kaptains.net","1in1.net","2chan.moe","social.lost-frequencies.eu","ygo.pub","social.drasticactions.site","societal.co","social.stlouist.com","mk.lightnovel-dungeon.de","mky.aqualitore-lily.com","mstdn.chitose.org","uysocial.live","social.ridetrans.it","mastodon.linuxtavern.org","toot.social","birb.space","chura-meet.mywire.org","friendica.hashy-net.de","live4you.one","mastodon.ind.ie","freewahaextremist.com","iamastodon.gifu.jp","mb.neurario.com","mastodon.jfmblinux.fr","friendica.eskimo.com","testingtesting123.xyz","koreadon.com","mk.pusang-ina-mo.ooo","dgng.no","toot.pt","mastodon.li","theosis.church","bocchi.social","borg.social","mk.lei202.com","hackers.town","fedi.9til.de","shadowverdon.info","estrogen.network","h.acki.ng","mastodon.crossfamilyweb.com","social.ancreport.com","mastodon.chotto.moe","mk.catgirlsfor.science","svq1.masto.host","catgirl.is","gnusocial.net","obese.cat","mastodon.mernacher.at","mastodon.lukem.net","kosmos.social","m.xunitc.org","dededon072.net","misskey.ruste.red","social.cyannyan.com","mastodon.mnethome.de","social.p0lymer.net","social.alyve.be","social.politicaconciencia.org","retrodon.jp","precure.ml","indiepocalypse.social","udon.pink","snowdon.jp","mstdn.cf","lm.korako.me","poast.tv","social.blep.cz","m.gyara.moe","brighteon.social","outerheaven.club","blitter.epgn.ch","facenet.netcorsoft.de","social.njms.ca","social.heldom.de","pleroma.atyh.cc","transgression.cafe","fediverse.pl","pl.wysteriary.art","ar.akarinext.org","pawlicker.ddns.net","notherweb.com","friend.geoffray-levasseur.org","malu.today","friends.undeadnetwork.de","pleroma.skyshanty.xyz","autizmo.xyz","shigusegubu.club","grosshans.online","bronyfurry.com","mastodon.mynameisivan.ru","podpro.biz","fedi.seriousbusiness.international","alive.bar","nayukana.info","bozgor.org","furrylife.online","schmaker.eu","friendica.daniel-siepmann.de","newsocial.tech","tilvids.com","honiskey.kmlg.jp","shitpost.cloud","halibut.com","flower.afn.social","castlecannon.house","conoha.cf","mugicha.club","hilo.masto.host","social.penguinability.net","taur.zone","mstdn.monster","ukadon.shillest.net","kagamisskey.com","pl.lain.sh","talos.link","a.gup.pe","toot.forth.works","zztails.gay","lagemeet.duckdns.org","goyslop.cafe","mastodon.starrevolution.org","mulmeyun.church","stream.labr.online","tooter.conman.co.za","ravenation.club","cheeseburger.social","mastodon.delta-t.work","jensenen.nl","hakodon.cf","hyenas.lol","mastodon.cct-cpc.org","mk.aaron.place","zirk.us","mastodon.xn--t8jzbl7g.jp","2m.cutls.com","handholding.gay","pr.shc.kanagawa.jp","pl.7ka.org","vibewave.space","ecoli.pink","pl.fediverse.express","dev1.simkey.net","tabinezumi.net","ralsei.moe","sysctl.io","kfem.cat","md.kakise.tech","charlestown.social","m.ix.is","social.undeadnetwork.de","ne.akarinext.org","mastodon.home.inndy.tw","mastodon.astrr.ru","arcadiaroad.com","mastodon.1984.cz","itmgitmo.com","improved-madness.de","social.nazileaks.eu","79120.tours","sementerrori.st","pl.brodi.me","ingwie.me","takumi.fun","ns.auction","niscii.xyz","pleroma.moth.monster","gensokyo.io","pl.comfysnug.space","toot.phseiff.com","neenster.org","pl.nikotile.xyz","freesoftwareextremist.com","rairarai.hostdon.ne.jp","club.elephantus.moe","sectorinf.com","fans.sonichu.com","balsillie.net","decept.org","social.matcha-soft.com","mstdn.fura.dev","m.dogcraft.top","misskey.yukineko.me","coywolf.social","mk.paritybit.ca","mstdn.nanamachi.net","mi.les-requin.net","wreck.rocks","social.3rensei.xyz","thetooniverse.xyz","pleroma.8777.ch","literatur.social","cmx.ee","mograph.social","wall.brackets-salad.com","ilyamikcoder.com","mstdn.crakac.com","misskey.shinaaamo.com","mewvinerse.masto.host","freetobe.social","dostoevsskey.com","loveforlandlords.com","unkomaker.hostdon.ne.jp","x0f.org","plus.haruk.in","uuuu.bigguys.club","movsw.0x0.st","www.chitterchatz.com","fedisabled.social","skaeya.com","misskey.chn.moe","misskey.korako.me","subversive.zone","mastodon.awful.monster","genitalia.observer","pegelinux.top","mobilize.berlin","birb.site","mdn.hinaloe.net","loves.reisen","techspace.social","bofh.social","pleroma.envs.net","kirapower.ichigo-hoshimiya.com","mstdn.love","ark.misskey.online","ente.fun","vocalounge.cafe","social.theplanet.rocks","social.protocol7.co","aspirant.de","kokt.club","mastodon.xy-space.de","mk.kirota.net","mastodon.kino.ma","pl.dira.cc","tgragnato.it","friendica.schuerz.at","social.fedinet.de","themintfarm.ml","s.zholnay.name","honkwerx.tech","news.twtr.plus","friendica.svasta.net","msk.porubu.com","v3.cathoderay.tube","social.romeov.me","neko.ci","blob.coffee","freeatlantis.com","bananachips.club","social.atridad.dev","gotosocial.kemonine.info","xn--kstenlouis-9db.de","nemushee.net","myasstodon.xyz","mastodon.se","nyan.nekoea.red","arcane.town","mstdn.res.ac","rgx.pt","gamemaking.social","7144.party","56ksocial.com","hellsite.net","social.tyngsboroughma.net","pleroma.marud.fr","brokenmirror.cc","blimps.xyz","shiina.cafe","friendica.kommune4.de","notk.ai","carnivore.social","pedo.house","misk.hoshisaki-h.com","autonomous.zone","2mb.social","gancio.cisti.org","layer13.p7.co.nz","mstdn.sanin.link","pleroma.nem.one","rabbit.tel","tardar.social","pleroma.paritybit.ca","wallera.computer","tube.ebin.club","birb.social","talk.ahoxus.org","tailswish.industries","culturewar.radio","pleroma.pt","romancelandia.club","mastodon.tux.ovh","lgbt.im","social.softmetz.de","nitecrew.rip","moonbeam.town","mastodon.ktachibana.party","wolfgirl.bar","pl.pclmulqdq.dev","commiespace.duckdns.org","tv.neue.city","su.siberia.work","tweep.club","biribiri.dev","herd.bovid.space","pl.m0e.space","social.jesuislibre.net","social.agb-web.de","mk.mozcmozc.club","live.retrostrange.com","news.psylodrumean.fr","social.decredcommunity.org","priv.menac.at","social.autonomy.earth","mastodon.eliotberriot.com","happytobehe.re","kafka.icu","social.cybre.city","sugoma.tk","xirion.net","rats-at.work","peertube.social","mk12.juggler.jp","misskey.zerozaski.tech","gingadon.com","candypolis.app","mstdn.one","pod.vladtepesblog.com","md.xps2.net","social.solibre.de","mk.vibbe.xyz","appdot.net","social.kartoffelcheetah.eu","ichiji.social","social.afront.org","mstdn.hokkaido.jp","misskey.cf","forfuture.social","bumpto.space","scholar.social","masto.a0s.de","cover.pm","society.kalli.st","p1.bucket.0ms.me","oransns.com","mstdn.amiantos.net","mr.am","aleph.land","staging.mstdn.maud.io","tines.spork.org","calculate.social","gamingjp.org","ypolis.net","4estate.media","keks.top","bbs.generallyrubbish.net","don.fetus.jp","mk.yuru.studio","masto.asonix.dog","meow.fan","blahaj.social","ludosphere.fr","igotit.io","social.secretsealing.club","post.letsdecentralize.org","obapom.work","mk.wataame.cafe","writee.org","mstdn.ffnet.work","submarin.online","howlsoverelpaso.xyz","glittersluts.xyz","qip.wang","mast.aaron.place","picosize.misskey.moe","pleroma.nfld.uk","slime.global","freespeechextremist.com","fedi.pcwizards.nl","social.kyushojitsu.ca","fedi.z0ne.moe","nonbiridon.hostdon.ne.jp","mastodon.tokyo","ourvillage.news","djanzu.tokyo","social.ignis.link","spearman.xyz","radiostatler.social","ser.endipito.us","langmerah.net","fediverse.tv","social.cryptonica.de","misskey.sagt.xyz","dabzyum.masto.host","uncorking.me","lizards.live","ak.kawen.space","concordia.social","stop.voring.me","zotsite.net","memesskey.com","social.pseudo-whiskey.bar","honk.petersanchez.com","landofkittens.social","pleroma.kitsunemimi.club","mastodon.randomroad.social","aurtun.masto.host","musksocial.com","pix.rheall.me","orbitalstation.one","focal.social","breakpoint.cafe","social.da-am.com","cybre.club","soc.sakrajda.eu","gazette.live","thisis.mylegendary.quest","nofan.xyz","wpbuilds.social","gravure.club","bittube.video","braydmedia.de","muffin.pm","videos.danksquad.org","social.berzs.xyz","akko.cuddlegirls.cafe","gladtech.social","tanukey.work","were.social","image.galaxycrow.de","icosahedron.website","friendica.some.rs","compostintraining.club","toots.social","bilibili.org","social.anacreonte.eu","cheeky.spokaneartcollective.com","dtp-mstdn.jp","allpro.social","snowdin.town","propulse.club","social.nombi.info","mk.udongein.reisen","h4.io","workaholic.cloud","so.fnky.nz","skyjake.fi","mastodon.steinernebruecke.de","gayhorse.club","types.pl","friendica.testitfor.me","mastodon.twilight-creation.com","kisslolis.moe","v10.minetaro12.com","unmensch.xyz","androiddev.social","crimew.gay","social.retronerd.at","social.homunyan.com","dresden.network","mstdn.plusminus.io","lhub.social","ak.lightnovel-dungeon.de","don.nzws.me","skeleton.army","app.kenhbit.com","fedi.pimoore.ca","pub.getgle.org","1o1.io","mastodon.trueten.de","friendica.ownbox.be","mastodon.mim-libre.fr","vindi.ca","19hundert84.de","rpvortex.online","retirenow.top","btc.gdn","rage.lol","toot.blue","dline.xyz","pl.slash.cl","social.lacoloc.cafe","shorty.masto.host","social.thecrow.uk","m.kirishima.cloud","mnufc.masto.host","exozy.me","barcelona.social","mis.syusyu.cloudns.nz","bussy.monster","b.z0ne.social","pleroma.gdgd.jp.net","utxo.id","nojob.jp","www.myonlinelife.social","onlinegemein.de","la-verite-vaincra.nohost.me","eicker.news","mastio.nl","mastodon.ppcis.org","balkan.fedive.rs","pomdon.work","toot.galaxycrow.de","blobfox.es","fedi.koyu.space","mastodon.party.at","plume.nogafam.es","hub.disroot.org","sager.wang","cocaineninja.de","pl.catboyindustries.co","puzzled.cc","freedom.horse","kraud.social","mk.outoftou.ch","onion.social","isidai.com","test1.syuilo.dev","social.yharnam.town","mastodol.jp","socialclub.nyc","jacksplace.dk","fedi.slipfox.xyz","rollenspiel.group","discorporea.com","barrett.fish","ani.work","gnomos.org","social.opendesktop.org","mastodon.bgzashtita.es","fuckgov.org","techporn.club","mlsskey.io","808.cybercity.eu.org","solagg.com","portal.0svc.com","d.c-cha.cc","pipou.academy","ip.omorashi.cc","abandoned.opprimonational.com","mast.moe","kopiti.am","misskey.sda1.net","robinsmediateam.dev","mastodon.creatrix.world","mastodon1.artsrn.ualberta.ca","iwatedon.net","mt.shc.kanagawa.jp","evil.social","poplava.net","jade.moe","lesbian.energy","swiss-talk.net","raru.re","fedi.debiantippse.de","piaille.fr","henshaw.social","social.gabekangas.com","space.escovan.net","fedilove.cyou","don2.inux39.me","masto.galaxycrow.de","octodon.social","zeroes.ca","dobbs.town","milker.cafe","beach.city","social.featyre.xyz","abyss.fun","fedi.fai.st","niichan.top","watch.thepolarbear.co.uk","mastodon.tech","social.quodverum.com","toot.icu","social.weho.st","follow.schmaller.de","underground-side-kochira-kotonoha.xyz","onlycasino.legal","kudabiverse.com","nixnet.social","loli.pizza","caffeinated.social","social.pebcak.de","libertalia.world","flauschig.social","social.dnlr.org","stackpointer.ws","photog.social","pixey.org","geofront.rocks","a2mi.social","novoa.nagoya","very.tastytea.de","write.as","abdl.link","ieji.de","toot.wales","gameliberty.club","stella.ocellaris.dev","wetdry.world","social.lol","novo-atlantis.null.media","hedgehog.pub","social.creatureofthehill.com","fandom.ink","nyaaa.jeder.pl","social.nomagic.uk","nerdculture.de","arena.seraimu.me","ioc.exchange","vicedomini.cloud","is-he.re","worldkey.io","yggdrasil.social","mk.outv.im","noovi.org","meisskey.nokotaro.com","distrotoot.com","mstdn.tamag.org","wandel.social","mastodon.nekocat.info","meganekeesu.tokyo","jv-net.digital","childpawn.shop","social.putin.agency","social.grimspound.net","totoro.live","ranran.tw","mastodon.mariobreskic.de","kopfkino.social","beefyboys.win","medic.cafe","queer.garden","freesocial.co","leafposter.club","sns.kiiro.dev","blessedgeeks.com","crlf.ninja","honk.waifuism.life","misskey.honahuku.com","mastodon.crazynewworld.net","together.chaoyu.us","falsy.cat","pleroma.miria.love","t2.thotsofa304.club","space.jeroenvd.nl","norden.social","the.xanny.family","pl.onpu.zone","mastodon.fjerland.no","misskey.nauzome.com","spacey.space","49six.club","social.chadland.net","qapp.cloud","iwanna.erase.nz","donotban.com","social.diva.exchange","petroskowo.pl","social.cryoit.com","xn--s8w913fdga.chn.moe","friend.tootafterdark.xyz","rumia.tk","sigmoid.social","muskodon.social","social.lemee.co","abid.cc","wxw.moe","seediqbale.xyz","mstdn.fr","social.anon-groups.de","z.fedipen.xyz","shitposting.army","stereophonic.space","skiddle.network","cho.yukiya.me","watadon.com","genau.qwertqwefsday.eu","fisherman.coelacanth-dream.com","pixelfed.gdgd.jp.net","functional.cafe","meisskey.blue","amala.schwartzwelt.xyz","friendica.chilemasto.casa","polaroid.absturztau.be","social.e-dt.xyz","media.fsfe.org","v2.ebano.social","mk.longyap.name.my","thapaliya.com","mk.nombi.link","quasselkopf.de","mstdn.omisosiru.net","mt.nightcore.monster","mstdn.quest","theboss.tech","rage.love","homoo.social","toot.gnous.eu","abhlach.ie","dixies.land","whinge.town","don.keyboardon.club","socialgoblins.club","liberdon.com","toot.mantyke.icu","wien.rocks","pleroma.getimiskon.xyz","nombi.link","freespeech.firedragonstudios.com","chitter.xyz","felesitas.cloud","pl.murky.club","snacka.uluntu.se","aidoru.cafe","mastodon.honeypot.im","pisskey.io","status.plomlompom.com","barmy.org","soc.k-a-i-f.ru","rakket.app","chungus.cc","pinkorange.red","krasovs.ky","amastodon.uk","towns.gay","pl.natehiggers.online","youngroyals.net","xn--y9azesw6bu.xn--y9a3aq","waifuism.life","houseofcreativeweirdos.com","mk.disqordia.space","xerg.ga","toot.party","devil-children-alitaso.com","refuse2.work","creacher.club","mast.mulliken.net","km6g.us","mat.tl","mastodon.cisti.org","r3pek.org","ungoverned.social","mstdn.mx","shortstackran.ch","cachapa.moe","mastodon.joinhaven.us","detroitriotcity.com","friend.snet.blog","girlcock.club","mk.gaycookie.dev","bbs.kawa-kun.com","pl.gnu.moe","cysioland.pl","soc.citizen4.eu","akko.saturno.black","g1zm0.social","live.hatnix.net","socks.pinnoto.org","debula.ml","social.johnassel.de","mstdn.netwhood.online","tiny.tilde.website","foxsay.southfox.me","thebunnyden.nohost.me","social.trom.tf","mastodon.dappital.co","geno.social","firebird.zone","social.ksite.de","astrodon.social","birds.garden","die-partei.social","lemmy.juggler.jp","lolison.top","linuxrocks.online","corteximplant.com","microblog.at","springbo.cc","pf.xiupos.net","misskey.ai","ak.cafkafk.com","tarasupadon.com","fet.bar","mk.voring.me","hikoukidon.jp","brotka.st","social.snopyta.org","misskey.sss-fc.com","edi.social","video.xiupos.net","plma.plus.st","xhais.love","hispagatos.space","luna.vg","walls.social","enovale.com","indiefedi.party","pl.thj.no","telescope.garden","click.ba.it","don.cs133.net","mstdn.nere9.help","misskey.endaaman.me","m.isle.moe","social.chiefgyk3d.com","lufimianet.jp","frnd.nanoscopic.de","kvlt.zone","under-bank.blue","rdrama.cc","musain.cafe","pl.devfs.xyz","blabber.rocks","mammouth.inframed.net","flokinet.social","mi.8mitsu.net","hina.house","m.brokep.com","unnerv.jp","free-badger-83.deno.dev","mk2.toyoko.in","geeknews.chat","mk.pupbrained.xyz","khiar.net","mk.toyoko.in","handicapped.tk","busy-bat-30.deno.dev","pcgamer.social","tweetnet.uc-netcorsoft.de","typo.science","gruene.social","mastodon.nzoss.nz","jorts.horse","marsey.club","standup-comics.net","social.mueller-post.de","dekameta.com","kansas-city.social","pkteerium.xyz","twit.social","eientei.org","atsuchan.page","mastodon.cipherbliss.com","mastodon.buzhangjiuzhou.com","kuloma.net","mastodon.lhin.space","friendica.myportal.social","photodn.net","sovran.me","what.weesefamily.ca","friendi.linuxand.beer","misskey.tebukuro.xyz","dasgelobteland.art","toot.seviche.cc","paidspeechextremist.com","nightcord.de","mastodon.malmorrow.com","mastodon.chasalin.nl","xgix.net","pleroma.amefur.asia","counter.social","www.cerebralmix.cc","im.allmendenetz.de","pleroma.cirno.digital","md.korako.me","mastogros.com","mastodon.content.town","mastodon.localecho.net","roleplayers.bub.org","mas.glowing.surf","lila.menac.at","quietplace.xyz","pleroma.electronblueberry.xyz","friendica.dezucked.com","rag.dog","husk.site","80percent.social","ndp.ipv6.club","social.securetown.top","thebigeasy.space","social.datalabour.com","ilias.church","mi.maikaze.moe","fem.social","don.bitma.st","social.tulsa.ok.us","m.zuiho.moe","port87.social","fedi.pawlicker.com","gochisou.photo","anticapitalist.party","nca10.net","social.media-techport.de","xxx.azyobuzi.net","en.osm.town","cldsrv.duckdns.org","glittersluts.club","mastodon.intentropycs.com","geeky.af","misskey.de","frennet.xyz","sully.site","hellsite.site","shrike.club","mstdn.delmulin.com","pone.social","orwell.fun","sonomu.club","sweet.succubi.services","zalem.city","federation.ninetiesmysteri.es","chat.brainbaking.com","staging.mastodon.social","r2.do","friendsyu.me","bearologics.social","mastodon.design","ostatus.taiyolab.com","masto.brightfur.net","frankenwolke.com","hemmer.land","kitty.town","xxivproduction.video","heislandmine.work","cathode.church","silvernight.social","social.silkky.cloud","sorcie.re","jakewharton.com","social.mx00s.com","soc.phreedom.club","my.bunny.cafe","poliverso.org","cawfee.club","bunny.cafe","pl.tsukuyomi.dev","pleroma.maciej.website","dingdash.com","hal9.ooo","linfan.moe","itmslaves.com","mastodon.aventer.biz","collapsitarian.io","438punk.house","social.atridad.cloud","idolheaven.org","controlfreak.live","qiitadon.com","fe.disroot.org","video.lemediatv.fr","friendica.wageoffsite.com","social.ravergram.club","ploptodon.com","blackjackandhookers.net","hell.social","m.anirloli.dev","retr0.id","www.no-thoccs.cc","russ.network","miss.mouse.services","m.intoxvs.info","lgbt.pm","avatastic.uk","artimec.social","cock.fish","sneed.social","techhub.social","gast.social","inconnu.uk","mastodon-example.tacoboutit.cloud","mastodon.chezmoi.cloud","mastodon.flying-snail.de","mstdn.sysinfra.info","nwf.earth","social.platypush.tech","queso.ninja","rainbow.lol","scottmorrison.net","soapbox-test.fly.dev","social.dumbly.net","social.mrjeda.de","social.umrath.net","social.xphera.eu","suivez.moi.ovh","toot.jaehne.cloud","tooter.cc","town.planetai.re","ttrpg-hangout.masto.host","tycho.monolith.social","blog.antopie.org","fr13nd5.com","overbye.dev","jumanji.co","prismo.fedibird.com","demoncore.info","msk.seppuku.club","plasticmodels.tokyo","chat.skiddle.id","misskey.assaultli.ly","misskey.chiffon-sepxipl.com","stream.ozoned.net","douchi.space","vulpine.club","ward2.bouvardia.icu","obo.sh","friendica.ingram-braun.net","orz.uno","mk.igwigg.space","poa.st","animesexual.community","andalucia.social","mastodon.uy","write.tchncs.de","fnx.li","toots.hwl.li","sns.tsubasaori.be","oti.st","chaos.social","friendica.mathernalproductions.com","fenetre.dev","tooot.im","neongrove.social","social.9tail.net","yyyyy.club","soc.mahodou.moe","vrparty.social","blazingopen.space","yanick.ca","gleasonator.com","nebbia.fail","onuu.uno","med-mastodon.com","stellar.build","vael.town","notnull.click","newskey.cc","freehub.space","mastodon.vhome.info","lolic.at","mastodon.la","muenchen.social","pivox.net","rojogato.com","pleroma.aaoth.xyz","rusoc.xyz","social.cryptography.dog","mastodon.rzgierskopp.de","kr.akirin.xyz","bergstrasse.social","toot.si","masthead.social","ihatebeinga.live","mk.cygis.cf","oslo.town","social.michels.xyz","mk.outsidermanga.com","0lb.be","gaku-tab-kill.com","misskey.probmkr.com","mastodon.nz","catcatnya.com","mastodon.slightlycyberpunk.com","t.basspistol.org","miss.nem.one","mindly.social","pnyhf.eu","social.screamingatmyscreen.com","social.birdsonbicycles.racing","xn--baw-joa.social","social.axbom.com","www.unattributed.cc","xyzzy.link","mastodon-nieuwspaal.nl","tonybark.com","gp.shoot1ng-star.site","social.dilavni.com","p.rhinoworks.info","mstdn.hostdon.jp","mastodon.dev-null.rocks","horserock.xyz","nimantu.de","bloor.tw","pl.fossworld.hu","pleroma.viridianpatriots.com","digipres.club","pl.gamers.exposed","moe.pastwind.top","social.fellr.net","social.yesterweb.org","dumbopinions.xyz","itabashi.0j0.jp","fedi.tyil.nl","contrapointsfan.club","bbq.snoot.com","mstdn.life","misskey.dokodare.ovh","kafeneio.social","chill.anchovies.pizza","mastodonnederland.online","mk.slipfox.xyz","fwedivewse.vfpmedia.com","mstdn.haku-kazamaru.club","pleroma.nobodyhasthe.biz","social.jesse-saenz.com","zone.liolok.com","imastodon.net","lgbt.io","libretooth.gr","cliq.social","uma.milkey.homes","mastodon.54park.de","misskey.cloud","mastodon.open-net.nl","social.data.coop","clacson.abiscuola.org","ruhr.social","toot.re","ostfrie.se","social.mikutter.hachune.net","don.paltee.net","chrispelli.fun","veganunity.rocks","camp.smolnet.org","jlelse.blog","soc.luciferi.st","grischa.de","soc.schuerz.at","post.lurk.org","toot9.de","kawen.space","kakampinks.com","nicecrew.digital","suma-ev.social","iddqd.social","pleroma.saturno.black","skeletons.gay","slippy.xyz","pleroma.cafkafk.com","beta.mstdn.cf","mastodon.vapronva.pw","masto.glorious-space.eu","antabaka.me","mastodon.partipirate.org","mastodon.bida.im","mastodon.retr0.party","gs.leftic.club","social.pixelgesicht.de","mi.tkw.fm","hidamari.apartments","friendica.oldkid.digital","campaign.openworlds.info","fairy.id","blob.cat","social.integritymo.de","the9thcircle.club","mstdn.gunma.jp","myopic.one","social.pondr.nl","social.uden.ai","peertube.stream","boitam.eu","gall.family","mi.growthers.dev","blog.witch.academy","d-fens.systems","thebag.social","plural.cafe","mistli.net","social.mit.der.bolt.durch.bayern","bruh.homd.xyz","citrus.farm","pleroma.doserver.duckdns.org","paypig.org","dudu.best","cowfee.org","mi.shi-jk.com","noize.guru","kpop.social","metaxx.dev","norrebro.space","co.misskey.io","topspicy.social","flowerpot.fyi","merlion.social","pleroma.leftychan.net","mstdn.philia.work","mastodon.huntsvillain.com","pret.life","misskey.phoebeivy.dev","gearlandia.haus","cabin.smokymountain.top","owncast.small-web.org","l33t.link","social.juanlu.space","tube.tchncs.de","equestria.social","mastodon.wenzit.de","chillout.chat","sunbeam.city","connectified.com","thehb.me","rebelsocial.media","body.social","social.naln1.ca","hashi.icu","sunisky.club","tusk.schoollibraries.net","social.zwoelfdreifuenfundvierzig.net","mieth.social","mastodon.pirateparty.be","social.gotterfunken.eu","mk.asie.pl","exdeck.site","toot.mattedwards.org","fed.sonnenmulde.at","tum.social","seaofog.com","rapemeat.solutions","notbird.site","snabelen.no","urbanists.social","digforfire.org","publicspaces.net","x0r.be","social.milchreislieferei.de","cum.camp","mstdn-amadeus.tech","b-c.social","mkey.nanasi-apps.xyz","koyu.space","social.michaelbrooks.co.uk","bbs.keinpfusch.net","mstdn.nekozuki.me","otoya.space","social.dorf-post.de","comerocudequemestalendo.com","social.wideboys.org","mastodon.creativegamer.net","toot.aquilenet.fr","groundpolis.app","scicomm.xyz","polyglot.city","psh.vercel.app","gly.one","twingyeo.kr","glitchbird.com","oceanplayground.social","mastodon.sk","mstdn.beer","depixelated.com","mstdn.sublimer.me","mescl.in","masto.pt","pleroma.nl3.vps.mrclon.net","c.im","digitalcourage.social","federated.media","mstdn.shihoya.tokyo","turkum.site","social.lb1a.de","elekk.xyz","pulpunte-chinpun.xyz","lethargic.talkative.fish","xn--trt-tna.sebtobie.de","pl.fanyx.xyz","space.rick.gr","cybt.de","leftist.network","varishangout.net","tdd.social","pleroma.nylarea.com","ooe.social","model-room.inux39.me","mastodon.cc","layer8.space","medibubble.org","o3o.ca","bikeshed.vibber.net","social.dev-wiki.de","hub.natehiggers.online","socnet.softgirl.online","canary.fedibird.com","redroo.ml","clubcyberia.co","friendica.hubup.pro","social.edu.ci","mstdn.starnix.network","social.macwinlin.cloud","mona.do","pmth.us","stereodon.social","initiate.space","spinster.xyz","linernotes.club","benign.town","kif.rocks","gangstalking.services","mastodon.dmgd.monster","www.librepunk.club","social.xenofem.me","warriorsofthelord.com","strausmann.net","yellowmustard.club","animal-crossing.mastportal.info","soc.ua-fediland.de","selfy.army","social.fbxl.net","lustigetiernamenbubble.de","ufm.lol","team1.rocks","misskey.weebcouncil.online","v2.flyingcube.tech","otogamer.me","laserdisc.party","willems.social","mastodon.eole.education","pukebucket.pedrocx486.club","busshi.moe","honi.club","libranet.de","climatejustice.global","epsilon-ix.masto.host","nightshift.social","acg.mn","sleepy.cafe","hello.2heng.xin","pouet.chapril.org","friends.sophiade.net","plume.pullopen.xyz","habets.dev","nekocave.xyz","social.x.caad.one","m.cmx.im","mastodon.fraize.com","soc.punktrash.club","puntarella.party","the.floof.rocks","respublicae.eu","twitter.1d4.us","unfediverse.com","uwu.social","fimidi.com","social.yanick.ca","kancolle.social","misskey.biribiri.dev","tootaloo.me","kwaa.moe","fag.lol","mapstodon.space","mastodontti.fi","minidisc.tokyo","kirishima.cloud","mis.ski","letsalllovela.in","squanch.xyz","pl.ebin.zone","bookwyrm.nops.red","mitsukey.cf","mastodon.nrsk.no","sociale.network","pl.valkyrie.world","bonkumiru.hacktivis.me","pleroma.narrativerry.xyz","nuked.social","democracy.town","libera.tokyo","monads.online","im-in.space","natehub.com","freecumextremist.com","maly.io","xtaldave.net","triangletoot.party","m.phase.org","explosion.party","misskey.7ka.org","ussr.win","tilde.zone","graz.social","friendica.vrije-mens.org","messurrection.com","crucible.world","moe.cat","m.x4s.io","federate.social","scl.clttr.info","lesbianschool.com","netmonkey.xyz","arachnid.town","porkmeeting.masto.host","misskey.bubbletea.dev","twtr.plus","eveningzoo.club","bibly.com","drosophila.social","mstdn.rndmm.us","mstdn.y-zu.org","fedi.intkos.link","bookwyrm.social","ryona.agency","horizin.de","live.w0rmh0le.net","mastodon.lb.minixer.com","grants.cafe","soc.catala.digital","youjo.love","asocial.jacquesetmichel.fr","mastodon.vda-group.de","dragn.gay","fog.highspirits.games","deadinsi.de","rollenspiel.social","mk.starnix.network","otp.akkoma.dev","fietkau.social","2pxnl.de","p1.a9z.dev","mastodon.cryne.me","chinwag.org","vmst.io","mastodon.puddle.farm","computerfairi.es","pixelfed.social","social.margiovanni.com","vt.social","mental.social","g0v.social","mstdn.kemono-friends.info","xn--rtta-qoa.nu","mastodon.me.uk","social.xbm.se","im.sb","tech.lgbt","toot.a-ef.org","hakurei.ga","minohdon.jp","misskey.social","mstdn.guru","mk.shc.kanagawa.jp","101010.pl","diode.zone","ukiyo.cafe","inuh.net","social.satan-speaks.com","cave.mancave.de","comicscamp.club","ura-mstdn.com","home.social","taruntarun.net","metaskey.net","mstdn.nerd-culture.tech","mk2.mstdn.life","suomi.social","cryptotooter.com","salon.fika.moe","wue.social","mastodon.iriseden.eu","mastodon.express","twipped.social","mk.f72u.net","masochi.st","b4udw3rk5.com","catgram.co","mstdn.science","m.noxie.ch","mastodon.pro","noisemakerbot.social","youthweb.social","allships.run","satania.social","futen.work","pl.cursed.observer","masto.rocks","msky.h3z.jp","mcnamarii.town","udongein.xyz","birdbots.leptonics.com","fumi.39.gy","pounced-on.me","comm.cx","tree.pigeons.cloud","onsen-musume.fun","mastodon.yyyyy.world","mstdn1.h3z.jp","miwkey.miwpayou0808.info","fedi.absturztau.be","fulda.social","pleroma.aorinngo.top","potate.space","social.unx.pw","mastodon.zone","tea.codes","art.librepunk.club","laviadililith.social","honi.stesan.dev","next.yncrypt.net","mk.sysk-work.net","rin.pink","m.mashiro.top","misskey.kurume-nct.com","sns.ymn.info","go.arkadi.one","puff.place","strelizia.net","mastodon.simulakrum.vpndns.org","pagan.plus","orchorde.masto.host","gnusocial.jp","social.icke.me","legal.social","mahiradon.com","social.metadata.moe","1210.nl","kcmo.social","social.tinytip.de","pythonist.as","altelectron.org.uk","peerverse.space","mastodon.underworld.fr","lou.lt","tanoshii.site","mstdn.moe","zenyasai.g-fukurowl.club","kiwifarms.cc","misskey.m544.net","mastodon.green","rdh27785.net","misskey.boon.chat","social.bau-ha.us","hyperpla.net","misskey.04.si","moresci.sale","charade.social","ffxiv-mastodon.com","social.blogsofwar.com","polonkai.eu","famichiki.jp","mastodon.compositecomputer.club","socel.net","mastodon.radio","soundcafe.nl","akkos.fritu.re","theguidrys.us","gaku-tab-love.com","sns.koyu.space","succubi.services","climatejustice.social","theres.life","mastodon.no2nd.earth","mastodon.art","frens.mahodou.moe","misskey.dev","msk.ilnk.info","stream.digio.space","mastodon.top","misskey.noellabo.jp","cafe.moien.net","pl.info.natehiggers.online","nightly.fedibird.com","ist.social","odakyu.app","cybercrusade.xyz","techlover.eu","dragons.fyi","cloudisland.nz","sneed.network","eeeeeeeee.eu","sometimes.social","retard.tech","drdr.club","jibun.club","pleroma.breizh.pm","jasette.facil.services","darmstadt.social","mastodon.digitalsuccess.dev","podcastindex.social","red.niboe.info","social.singing.dog","k.lapy.link","masto.astrra.space","gaymer.social","mk.toast.cafe","hermit.cafe","dragon-fly.club","msnis.radiate038.com","arathe.net","post.ebin.club","cum.salon","mstdn.co.uk","mstdn.cuezakuisgodofthe.world","social.caserio.de","1042.info","mstdn.bougiekitty.net","fedi.lowpassfilter.link","mashed.cloud","mastodon.kitchen","vandrare.page","cyberstorm.one","fedi.nullob.si","m.rakyll.org","mastodon.zaclys.com","social.vekant.com","m.markjones.cloud","mk.mozc-plasma.tech","mastodon.geekery.org","social.aero","mastodon.coffee","dice.camp","moosetodon.com","nnia.space","toot.works","mk.shrimpia.network","plush.city","social.coop","kimpire.net","pdx.social","m6n.io","socks.masto.host","mastodon.sdf.org","nobigtech.es","kuinya.net","kiritan.work","mastodon.gamedev.place","mastodon.arch-linux.cz","fightforthefuture.org","hachyderm.io","liker.social","ma.fono.jp","helladoge.com","infosec.exchange","donphan.social","hostux.social","sauropods.win","meow.social","mastodon.ie","mastodon.scot","lor.sh","mastodon.nl","tooting.ch","biplus.date","phpc.social","mk.yopo.work","weirder.earth","handon.club","qoto.org","okadon.masto.host","mastodon.ryotak.me","mastodonapp.uk","leadrdrk.eu.org","loma.ml","silversword.online","mastouille.fr","foresdon.jp","heylisten.social","drizzle-damp.net","data-folks.masto.host","pettingzoo.co","fedisnap.com","noc.social","awscommunity.social","mastodon.xyz","masto.donte.com.br","cybre.space","eldritch.cafe","toot.community","anime.website","writing.exchange","cdrom.tokyo","chudbuds.lol","netpro2k.io","mastodon.insicurezzadigitale.com","baraag.net","snug.moe","iyasaretai.pw","bonn.social","mastodon.lol","arlington.social","indieweb.social","mstdn.jp","du.capricom.info","romca.tk","misskey.io","journa.host","vocalodon.net","masto.ai","pawoo.net","sueden.social","social.tchncs.de","mastodon.online","ruby.social","mastodon.cloud","mstdn.social","unbound.social","fedibird.com","mastodon.uno","aus.social","mastodon.social","troet.cafe","catdon.life","sfba.social","kolektiva.social","kazv.moe","fosstodon.org","mas.to","glasgow.social","canada.masto.host","pokemon.mastportal.info","best-friends.chat","bookwor.ms","cztwitter.cz","riddly.rakka.tk","tablegame.mstdn.cloud","goblin.technology","mk.shiro.ink","todon.eu","u-tokyo.social","akkoma.thejar.club","matitodon.com","wikis.world","dizl.de","muttered.radiate038.com","todon.nl","hci.social","fedi.vern.cc","mstdn.io","genomic.social","social.goodanser.com","mstdn.seerr.dev","planet.moe","retrochat.online","witches.live","jawns.club","m.beiting.org","darkfriend.social","zov.oti.st","coffeechat.social","social.rebased.network","fedi.astrid.tech","mastodon.parastor.net","mofmof.coffee","mastodon.nyanshell.com","borahae.love","mastodon.com.br","social.linux.pizza","queer.party","wandering.shop","sudo.cat","hessen.social","mastodon.world","freeradical.zone","sunny.garden","oliphant.social","treehouse.systems","merveilles.town","matthewedavis.online"]
0

