HTTP/1.1 200 OK
Connection: close
Transfer-Encoding: chunked
Access-Control-Allow-Origin: *
Alt-Svc: h3=":443"; ma=86400, h3-29=":443"; ma=86400
Cache-Control: max-age=86400, public
Cf-Cache-Status: DYNAMIC
Cf-Ray: 767788b63c6483de-BRU
Content-Security-Policy: frame-ancestors *.crabdance.ca crabdance.ca *.c-and-c.ca c-and-c
Content-Type: application/json; charset=utf-8
Date: Wed, 09 Nov 2022 15:20:43 GMT
Etag: W/"ce1ecc3138d55022a7dc0057c0e85e5f"
Nel: {"success_fraction":0,"report_to":"cf-nel","max_age":604800}
Permissions-Policy: interest-cohort=()
Report-To: {"endpoints":[{"url":"https:\/\/a.nel.cloudflare.com\/report\/v3?s=z1JgAbtNqVJ45SLxJCW1sFQhLFDd1Tje3BCDYzCGrMZAA1rAFg74XaS5WJRYJvs8HghYs8qbi3T1vIIRxINtBp%2BVoO%2BF1jkx%2BLyQXcYVCTsyDZkQQPRtArykXPXSbNWl%2BPSN"}],"group":"cf-nel","max_age":604800}
Server: cloudflare
Server-Timing: cf-q-config;dur=8.000002708286e-06
Strict-Transport-Security: max-age=15552000; includeSubDomains; preload
Vary: Accept-Encoding, Origin
X-Content-Type-Options: nosniff
X-Download-Options: noopen
X-Frame-Options: SAMEORIGIN
X-Permitted-Cross-Domain-Policies: none
X-Ratelimit-Limit: 300
X-Ratelimit-Remaining: 299
X-Ratelimit-Reset: 2022-11-09T15:25:00.818455Z
X-Request-Id: d4301993-4ce1-4a1e-b8db-9732976eb3c6
X-Runtime: 0.004459
X-Sso-Wat: You've just been SSOed
X-Xss-Protection: 1; mode=block

5f2c
["mastodon-relay.thedoodleproject.net","relay.chocoflan.net","flm9.me","pleroma.gronkiewicz.dev","redeyes.club","pixel.geneticjen.com","f.iroiro.party","mastodon.fedja.fi","pl.lain.sh","gamedev.lgbt","desu.social","pl.craftplacer.moe","suomi.social","mastodon.trueten.de","mastodon.neilzone.co.uk","paquita.masto.host","themepark.social","satania.social","coales.co","dindon.one","cutiehaven.club","fr.readthefinemanual.net","obsidian-group.co","xn--xxa.computer","fedi.pawlicker.com","s.lennysh.com","quitter.pl","cryptocartel.social","sometimes.social","mastodon.ar.al","kudabiverse.com","social.skrep.in","bajax.us","toot.gru.social","mastodon.infra.de","mementomori.social","elle.systems","pleroma.doingyourmom.club","fluff.land","magnificentbeardsfan.club","acegiak.net","josh.tel","marzillier.net","m.markjones.cloud","mastodon.huntsvillain.com","438punk.house","masto.astrra.space","mstdn.itsnero.com","social.bitwig.community","a.sc","nuked.social","darmstadt.social","gladtech.social","fd.inggrismantap.my.id","toot.ahnlak.com","fnordon.de","recsys.social","freezepeach.online","fightforthefuture.org","social.polymerwitch.com","shigusegubu.club","the.goofs.space","anarchydica.net","noam.horse","infosec.exchange","laserdisc.party","gly.one","fri.aethercom.de","mastodon.audiophilestyle.com","socialwagrien.de","hodlr.one","fediverse.pl","hagew.blog","friendica.mschmidt-et.de","thisis.mylegendary.quest","hub.natehiggers.online","social.satan-speaks.com","mastodon.retr0.party","pix.rheall.me","riddly.rakka.tk","social.jmueller.eu","social.theplanet.rocks","friendica.mifritscher.de","twipped.social","asimon.org","hub.uckermark.social","mastodon.org.uk","poa.st","muro.undernet.uy","friendica.offsite.guru","pullopen.xyz","sneed.social","mastodong.lol","m.servperso.net","v2.ebano.social","nervesocket.com","social.sp-codes.de","intahnet.co.uk","unix.dog","depixelated.com","cornichon.me","ruby.social","masto.technology","rapemeat.solutions","relay.fedi.agency","fr13nd5.com","lustigetiernamenbubble.de","ovo.st","heidel.berg.social","talk.mls20.de","udongein.xyz","russ.network","astrodon.social","social.azkware.net","friendica.kommune4.de","misskey.sharivegas.com","tane.codes","mastodon.puddle.farm","social.evotm.com","mk.szkod.ovh","misskey.de","so.fnky.nz","vmst.io","fedi.cc","zef.social","social.xenofem.me","tooot.im","mn.tlf.pw","mastodon.sandwich.net","pl.gamers.exposed","merovingian.club","toot.thedoodleproject.net","pleroma.wafflec.one","fedimon.uk","cybre.space","social.diekershoff.de","ligma.pro","mstdn.co.uk","atomicpoet.org","pleroma.stream","seocommunity.social","theres.life","fedi.xerz.one","akko.saturno.black","shitpost.poridge.club","pixelfed.de","seafoam.space","akko.wtf","snug.moe","mastodon.hsablonniere.com","dan.mastohon.com","skull.website","a2mi.social","ellieayla.net","notk.ai","fedi2.caliandroid.de","mammoth.gry.st","strelizia.net","clar.ke","angrydome.au","cuff.social","mastodon.bloonface.com","social.kabi.tk","robot.rodeo","universe.d3ds3c.net","anime.website","gulp.cafe","mastodon.cryne.me","mittn.ca","pliocene.org","polonkai.eu","hostux.social","open.audio","analogue.social","pxlmo.com","lonely.town","1210.nl","herzbu.de","dib-social.bewegung.jetzt","mastodon.cryobyte.net","mastodon.raffi.de","sergal.org","mst.universoalterno.es","pleroma.envs.net","soc.texto-plano.xyz","yggdrasil.social","social.bigger6.com","fedi.astrid.tech","sfba.social","squanch.xyz","rubber.social","leadslinger.org","astronomy.social","fex.techbio.eu","turnip.solutions","pwestbro.social","microblog.social","old.mermaid.town","systerserver.town","mastodon.nu","romancelandia.club","mastodon.com.tr","nahe.social","muenchen.social","z0ne.social","birb.site","mastodon.mit.edu","friendica.ambag.es","social.mysticalartai.com","defenders.town","ryona.agency","social.manalejandro.com","tried-to-do.science","anvil.social","florianjensen.com","uncorking.me","social.undisruptable.technology","yharnam.singles","flyovercountry.social","starbase80.wtf","lol.camp","simian.rodeo","djsumdog.com","niscii.xyz","chatterbook.us","social.rebellion.global","strausmann.net","mastodon.opportunis.me","xn--p1abe3d.xn--80asehdb","newsie.social","social.fedinet.de","m.brokep.com","toot.works","tyrol.social","mastodon.partipirate.org","pl.valkyrie.world","raccoon.place","wake.st","rheinland.social","mcd.dk","democord.masto.host","social.owlcode.tech","m.rakyll.org","xhais.love","fedi.technodro.me","is.badat.dev","social.claes.se","glaceon.social","schykle.com","poto.cafe","mk.shatteredpalisa.de","uuchten.lu","3dp.chat","live.retrostrange.com","breakpoint.cafe","ooops.cloud","social.overlappingmagisteria.org","rouge.eu.org","notjustbikes.com","dragons.fyi","hub.brockha.us","share.tube","ossum.net","artraige.masto.host","social.michaelbrooks.co.uk","shitpisscum.mooo.com","ai-ml.masto.host","friendica.ucy.de","kurosawa.moe","social.fedcast.ch","henshaw.social","graz.social","schleuss.online","forum.friendi.ca","honey.town","social.fellr.net","wandzeitung.xyz","toot.re","knoxodon.com","openbiblio.social","digipres.club","retrotweets.com","were.social","social.benjamin-westland.de","waifuism.life","youjo.love","h4.io","chrispelli.fun","mastodon.helvetet.eu","links.potsda.mn","the9thcircle.club","ghetti.monster","pagan.plus","scalie.business","social.singing.dog","m.sclo.nl","berserker.town","minidisc.tokyo","legal.social","retrochat.online","freecumextremist.com","skippers-bin.com","7td.org","schutt.social","crlf.ninja","cooler.mom","eientei.org","sperg.city","miniwa.moe","misskey.gothloli.club","codatory.com","justicewarrior.social","piggo.space","refusal.biz","aus.social","mastodon.macsnet.cz","meow.social","nnia.space","pkteerium.xyz","acg.mn","mellified.men","frmsn.space","dresden.network","halt.cl","mastodon.se","spinster.xyz","ausglam.space","pixel.artemai.art","chitter.xyz","youdabomb.social","oslo.town","mastodon.mg","xarxa.cloud","sciences.social","spacey.space","leftist.network","oliphant.social","pleroma.kitsunemimi.club","friendica.togart.de","lgbt.io","social.veraciousnetwork.com","loa.masto.host","bikeshed.party","tastybugs.club","pleroma.nylarea.com","moosetodon.com","freespeechextremist.com","monads.online","froth.zone","social.mrhands.horse","godforsaken.website","mastodon.star-one.org.uk","arachnid.town","tomtaylor.co.uk","social.076.ne.jp","pleroma.jamesp.org","kabuki.club","iscute.moe","akko.anemoneya.me","mastodont.cat","fediverse-lite.com","charade.social","odenwald.social","social.artemai.art","toot.site","glammr.us","boing.world","pleroma.cafkafk.com","democracy.town","me.ns.ci","beefyboys.win","frontrange.co","social.network.europa.eu","masthead.social","mastodon.skaggsfamily.us","mastodon.prettyrequiem.com","mythago.space","pisskey.io","social.bennypowers.dev","shitpost.racing","toot.cafe","medibubble.org","offworld.fedisonic.cloud","lbry.world","petroskowo.pl","mastodon.hawaga.org.uk","netmonkey.xyz","code4lib.social","social.freeipad.info","catcatnya.com","sindicato.social","social.chiefgyk3d.com","goblin.technology","mstdn.pedrocx486.club","fuckgov.org","friendica.me","fikaverse.club","rcsocial.net","sigint.life","k.iim.gay","safejust.space","chat.noelle.codes","glitterkitten.co.uk","mk.chocoflan.net","social.mezzo.moe","qapp.cloud","shitpost.cloud","simonwillison.net","freindal.hallertau.social","fedi.lowpassfilter.link","toot.lgbt","dummy.cafe","blimey.social","social.cryptography.dog","maly.io","social.illegalpornography.com","lethargic.talkative.fish","wikis.world","brotka.st","greenplenty.social","cybercrusade.xyz","pirateradio.social","fedi.intkos.link","urchan.org","autonomous.zone","mastodon.chriswiegman.com","twit.social","lviv.social","social.zwoelfdreifuenfundvierzig.net","foxtail.ooo","social.growyourown.services","clubcyberia.co","gorf.pub","freak.university","pawoo.net","follow.schmaller.de","lounge.fan","husk.site","khp.ignorelist.com","pleroma.8777.ch","lain.com","girevik.su","slime.global","fedi.absturztau.be","lawfedi.blue","letsalllovela.in","eurovision.social","birdsite.thorlaksson.com","blog.writefreely.org","lolison.top","chinwag.org","sysctl.io","social.afront.org","mastodon.hofud.com","news.twtr.plus","social.okoyono.de","zov.oti.st","trans.enby.town","mystic.lgbt","hsnl.social","plume.nogafam.es","mindly.social","pixelfed.social","p1.a9z.dev","gleasonator.com","social.dev-wiki.de","social.adlerweb.info","network47.net","evil.social","halibut.com","misskey.hw2k.com","shelter.moe","otters.at","edi.social","mk.mistli.net","mastodon.wenzit.de","mirr0r.city","mastodon.derveni.org","social.lacoloc.cafe","federation.ninetiesmysteri.es","ludosphere.fr","cuscuz.in","aana.site","ned.masto.host","sideslip.social","mastonederland.nl","compostintraining.club","allpro.social","fandom.ink","treehouse.systems","lemmy.ml","aachen.social","bsd.network","linuxrocks.online","zhub.link","econtwitter.net","fedisnap.com","livellosegreto.it","sharma.io","blahaj.social","toots.cordelya.net","hofra.rocks","mastodon.pl","pixelfed.wageoffsite.com","masto.wayde.tech","social.tnhh.org","lgbtqia.space","friend.camp","kamu.social","social.xbm.se","piratenpartei.social","chilemasto.casa","researchbuzz.masto.host","ni.hil.ist","craftcat.dev","woof.group","mastodon.scot","peertube.openstreetmap.fr","grigson.live","cawfee.club","pleroma.foxfam.club","social.hispabot.freemyip.com","psyopvict.im","manyworlds.fit","yiff.life","fandom.community","inuh.net","social.handholding.io","gamingjp.org","nobigtech.es","friendica.hashy-net.de","libretooth.gr","pooper.social","theguidrys.us","pokemon.mastportal.info","timetheft.social","dryad.gay","social.bearveloper.dev","zztails.gay","emily.news","am.pirateradio.social","skye.vg","posting.lolicon.rocks","fenetre.dev","social.blogsofwar.com","cybre.town","twhtv.club","mastodon.geneticjen.com","pixel.noff.co","mastodon.sphericalk.at","chancellor.social","thebull.app","umaskey.net","dog.lgbt","tilde.zone","mstdn.satania.social","v.st","p.enes.lv","vran.as","appellate.social","m.adju.st","social.wildeboer.net","pl.seahorse.sh","springbo.cc","fet.bar","mk.toast.cafe","mastodon.radio","portal.0svc.com","social.hardlimit.com","snug.town","thetooniverse.xyz","hoob.io","noc.social","netzsphaere.xyz","nangang.travnewmatic.com","tallulah.fi","raxx.la","borg.social","mastodon.beer","social.deadsuperhero.com","piaille.fr","mastodon.top","beach.city","mastodon.simulakrum.vpndns.org","birb.space","verified.mastodonmedia.xyz","mstdn.starnix.network","social.bcicorporate.com","blackblock.rocks","social.tripulse.net","eldritch.cafe","famichiki.jp","anonsys.net","thicc.horse","mapstodon.space","blob.cat","curious.simio.us","mastodon.crazynewworld.net","skoops.social","bungle.online","rageparty.club","mk.gabe.rocks","pleroma.salastil.com","elekk.xyz","social.rebased.network","live.burningpixel.net","thecum.zone","strangeparts.com","fed.xnor.in","mastodon.sxpert.org","vancity.social","bytetower.social","lawtalk.social","mstdn.husku.net","friendica.daniel-siepmann.de","aspiechattr.me","screenwriting.space","libranet.de","neurodifferent.me","collapse.cat","mastodon.nl","mastodon.cgx.me","social.platypush.tech","outerheaven.club","lizards.live","m.janri.de","ser.endipito.us","social.masto.host","unstraight.club","sandiegourbanists.com","mstdn.esp.nl","r2.do","outpoa.st","inaccessible.ac","bofh.social","tube.grin.hu","cast.samsai.eu","vibewave.space","coldrick.me.uk","mastodonnederland.online","eupublic.social","wetdry.world","mathstodon.xyz","xtaldave.net","social.beepboop.ga","redliberal.com","social.bund.de","mstdn.fr","www.ianbrown.tech","earfolds.com","cheeseburger.social","nya.social","kfem.cat","mobilize.berlin","social.mootje.be","werd.social","toothole.org","miss.mouse.services","tiphon.nerv-project.eu","tuusin.misono-ya.info","social.tinytip.de","data-folks.masto.host","social.undeadnetwork.de","podlibre.social","bozgor.org","mastodon.tedomum.net","rojogato.com","tube.tchncs.de","friendica.chilemasto.casa","shaktzu.org","plush.city","social.producer-network.de","cloud-native.social","indoverse.nl","artisan.chat","social.gitea.io","epicyon.libreserver.org","dads.cool","mieke.club","contrapointsfan.club","video.lemediatv.fr","social.seattle.wa.us","mastodon.bayern","comicscamp.club","gs.leftic.club","bunt.social","girlcock.club","video.blender.org","comfyboy.club","movsw.0x0.st","appdot.net","mastodon.bida.im","solarpunk.moe","blimps.xyz","hostsharing.coop","tooter.social","peertube.stream","idlethumbs.social","the.voiceover.bar","mastodon.acc.sunet.se","fedi.neuwirth.priv.at","masto.social","pleroma.triggeredtux.com","piipitin.fi","ffflorian.social","kith.kitchen","librem.one","stop.voring.me","mugicha.club","noagendasocial.com","metalbanana.net","manx.social","toot.bldrweb.org","demon.social","pod.appliedmachine.app","beta.birdsite.live","nitecrew.rip","pl.nudie.social","social.saarland","toot.thoughtworks.com","bonn.social","gotosocial.kemonine.info","diode.zone","red.niboe.info","efdn.club","vt.social","barcelona.social","cdrom.tokyo","social.chatty.monster","climatejustice.events","engmanager.space","gaminginthe.cloud","radiosocial.de","freespeech.group","fedi.nullob.si","techforgood.social","kakafe.ga","lsbt.me","exploit.social","kolektiva.social","neenster.org","todon.nl","bayes.club","sunbeam.city","social.anartist.org","floss.social","d-64.social","mstdn.beer","xoxo.zone","ak.lightnovel-dungeon.de","masto.donte.com.br","mstdn.ghastr.com","braydmedia.de","fimidi.com","bitcoinhackers.org","retr0.id","social.weho.st","warhammer.social","bawue.social","masto.ezhevita.dev","hessen.social","soulzeppel.in","mastodon.parastor.net","diaspodon.fr","hci.social","x0r.be","recurse.social","brockha.us","primitivebits.social","meis.space","fandom.garden","kvlt.zone","mycrowd.ca","twingyeo.kr","jade.moe","poly.cybre.city","mk.vulpes.one","social.cool110.xyz","hackerdrinks.social","iddqd.social","qaf.men","social.ppmx.org","nixgeek.com","goblin.camp","sully.site","glitch.taks.garden","odakyu.app","social.ridetrans.it","mastodon.humanists.uk","dariox.club","whinge.town","post.ebin.club","quarteredcircle.net","craftodon.social","socialserver.science","mastodon.dragoncave.dev","3dart.social","pl.comfysnug.space","pirati.ca","die-partei.social","friendica.opensocial.space","danp.net","velocipederider.com","fulda.social","toot.wales","stereophonic.space","mastodon.indie.host","peerverse.space","social.espeweb.net","soc.umrath.net","moessingen.social","libutzki.de","fediscience.org","social.futurnumerique.com","writing.exchange","port87.social","shrike.club","ewing.au","loma.ml","mstdn.jp","nya.one","0lb.be","mein.mikroblog.at","det.social","skeptics.social","ecoevo.social","chaos.social","climatejustice.video","akko.disqordia.space","mastodon.tetaneutral.net","social.pmj.rocks","assortedflotsam.com","cum.salon","mastodon.cf","mastodon.zaclys.com","tea.codes","snabelen.no","tweep.club","retro.social","masto.henkkalaukka.fi","dair-community.social","jawns.club","toot.kartonrad.de","cryptotooter.com","puntarella.party","social.ei8fdb.org","akkos.fritu.re","climatejustice.global","sheffield.pub","social.dbot.dev","wue.social","misskey.bubbletea.dev","social.lovingexpressions.net","pieville.net","pleroma.cyberdelia.com.ar","indieweb.social","sunny.garden","ieji.de","gnusocial.net","hashi.icu","social.unraidcloud.de","pleroma.primitivebits.com","freeatlantis.com","a.gup.pe","bookwor.ms","toot.houbahouba.de","therobots.org","aeracode.org","pfalz.social","social.dsmouse.net","toot.conrad.cafe","mastodon.uno","giersig.net","journa.host","tooty.org","glasgow.social","comunidad.nvda.es","estrogen.network","venera.social","mastodon.geekery.org","sauropods.win","social.helpmedog.com","tube.undernet.uy","deepspace.social","c.im","social.gomen.de","embassy.social","pl.tkammer.de","ilyamikcoder.com","firmware.network","misskey.noellabo.jp","signs.codes","wandering.shop","piraten-partei.social","fediverse.one","rdrama.cc","weburbanists.com","tbo.social","hates.company","clacks.link","social.welford.me","pleroma.elementality.org","en.osm.town","cathode.church","toot.me.uk","pleroma.skyshanty.xyz","ubuntu.social","akko.cuddlegirls.cafe","corteximplant.com","anime-titties.com","toot.dragon2611.net","pythonist.as","cloudisland.nz","varishangout.net","social.secretsealing.club","mastodon.fam-ribbers.com","whitespashe.uk","social.wageoffsite.com","mk.slipfox.xyz","skynate.net","introvert.social","mar.archipielago.uno","federate.social","sociable.cafe","mastodon.surazal.net","ftp.rip","alive.bar","akademienl.social","gameliberty.club","someone.elses.computer","k8s.social","social.bau-ha.us","bhre.social","erratic.cc","social.cloudron.io","cryptodon.lol","dica.interfel.de","mastodon.dmgd.monster","stoopid.club","social.anthro.cc","treecast.com","expired.mentality.rip","nrw.social","thepit.social","bne.social","cyberstorm.one","queer.garden","mastodonsocial.au","fed.sonnenmulde.at","tragi.cc","tree.pigeons.cloud","lesbian.solutions","megatherium.slothcloud.com","pandas.social","pdx.social","quanta.wiki","bakunet.me","social.lol","mastodon.exitmusic.world","assemblag.es","muh.wang","friendica.myportal.social","xerg.ga","oliverfalvai.xyz","social.dexzone.es","shpposter.club","layer8.space","hejfolks.social","respublicae.eu","plma.plus.st","bananachips.club","kitty.town","666.glitchwit.ch","schelling.pt","jorts.horse","shitposting.army","chudbuds.lol","campaign.openworlds.info","mspsocial.net","ihatebeinga.live","elfnostate.info","mastodon.technology","haha.rocks","wuff.space","tinat.eu","shortstackran.ch","mamot.fr","saturation.social","social.fluffel.io","pleroma.nobodyhasthe.biz","squeet.me","rag.pub","social.fpsource.info","mstdn.love","handmade.social","lehrerzimmer.social","asyncapi.social","mastodon.world","petrous.vislae.town","birdbots.leptonics.com","echo.nullzone.fr","leds.social","rando.social","social.rights.ninja","m.butt.dev","thebene.fit","twtr.plus","mstdn.mx","mastodon.murkworks.net","ubiqueros.com","blop.social","ak.kawen.space","mastodon.ml","misskey.io","pl.comofas.org","mastodon.nzoss.nz","selfy.army","freechat.ro","fedi.relms.dev","social.jacobandersen.dev","leafposter.club","c18.masto.host","social.tulsa.ok.us","flynn.me.uk","ourempty.pub","retro.pizza","colliderbias.net","social.inex.rocks","med-mastodon.com","mastodon.westsideblogger.eu","epistolary.org","toot.si","camp.smolnet.org","daedal.io","dice.camp","fosstodon.org","101010.pl","suedi.club","seal.cafe","boitam.eu","hact.org","snowdin.town","neat.computer","ap.maladaptive.art","wolfgirl.bar","pl.nulled.red","sleepy.cafe","fedi.tyil.nl","social.dog-s.global","mastodon.matrix.org","mastodon.acc.umu.se","troet.cafe","mast.gg","ork.institute","hypercube.masto.host","provo.lol","berlin.social","m.beiting.org","monsterfuckers.online","milker.cafe","myasstodon.xyz","mstdn.bx23.net","soc.schuerz.at","hachyderm.io","octodon.social","federated.press","calobar.club","mastodon.iow.social","horche.demkontinuum.de","gultsch.social","hellsite.site","moien.net","toot.teaandkittens.com","dizl.de","mendeddrum.org","indiehackers.social","muenster.im","masto.glorious-space.eu","is.nota.live","masto.namwen.me","plr.inferencium.net","noitl.space","toot.fedilab.app","literatur.social","fedisabled.social","gsg.live","plem.sapphic.site","mastodon.hams.social","0x40.au","social.ataxya.net","social.yampp.de","campfire.farwalker.ca","social.shorkpit.xyz","linksgruenversifft.social","mstdn-nicholl.uk","nixnet.social","towns.gay","mk.starnix.network","col.social","o3o.ca","meta.masto.host","loci.onl","gorf.space","toot.9wd.eu","needsmore.pizza","social.coop","mstdn.io","flimpie.net","sciences.re","aleph.land","fedi.theepicblock.nl","social.donar.dev","social.nicolas-constant.com","indiepocalypse.social","xn--baw-joa.social","social.icke.me","bbq.snoot.com","social.nofftopia.com","social.lansky.name","ursal.zone","mk.absturztau.be","mastodon.wssmagazine.com","hub.bayliss.social","metalhead.club","nightshift.social","social.beachcom.org","friendica.opencloud.lu","mastodon-belgium.be","mastodon.cc","arks.social","framapiaf.org","sociale.network","toot.cat","mstdn.kemono-friends.info","feed.victor.earth","bae.st","soc.7thmagic.net","n-odes.social","scicomm.xyz","friendica.produnis.de","embracing.space","icosahedron.website","detroitriotcity.com","freiburg.social","peoplemaking.games","dragonscave.space","m.moec.top","pony.social","social.anoxinon.de","fedibird.com","tuiter.rocks","socialgoblins.club","nitech.online","masto.pt","mstdn.media","sueden.social","mastodon.frkn.co","mastodon.transneptune.net","fedi.cheeseland.xyz","appbucket.io","lesbianschool.com","pleroma.manicphase.me","bloor.tw","counter.social","elevenways.be","gensokyo.social","social.cologne","mastodon.rzgierskopp.de","toot.jokiller230.tk","coletivos.org","bolha.us","nerdculture.de","techspace.social","eventos.coletivos.org","baraag.net","rage.love","awscommunity.social","oldbytes.space","oceanplayground.social","mxtthxw.art","mastodon.nz","kanoa.de","esquite.mazorca.org","bildung.social","xarxamontgri.masto.host","mastodon.uy","pixel.nobigtech.es","rollenspiel.social","liberdon.com","mastodonapp.uk","dobbs.town","swiss.social","subversive.zone","im-in.space","im.allmendenetz.de","masto.ai","waytoohip.com","mastodon.social","mstdn.social","dragon.style","social.here.blue","raggedfeathers.com","mastodon.design","mastodon.dev-null.rocks","hackers.town","meow.lgbt","phpc.social","ioc.exchange","mas.to","post.lurk.org","m.geraffel.net","miruku.cafe","mastodon.gal","weirder.earth","genomic.social","vulpine.club","extwitriates.com","mastodontech.de","tilvids.com","plural.cafe","yellowmustard.club","mastodon.ie","lipsia.casa","2c.taoetc.org","mastodon.art","sigmoid.social","mastodon.holeyfox.co","snapp.social","pixels.jdt.io","macaw.social","tabletop.social","universeodon.com","mastodon.hccp.org","masto.design","amicale.net","tabletop.vip","anticapitalist.party","social.pixels.pizza","anarchism.space","mastodon.bofhers.es","gruene.social","polyglot.city","hispagatos.space","mastodon.me.uk","vitaulium.nl","m.cmx.im","digitalcourage.social","masto.rocks","podcastindex.social","climatejustice.social","triangletoot.party","dogsex.org","botsin.space","sigpipe.me","smores.town","basspistol.org","mastodon.hamster.science","andyd.uk","helladoge.com","skastodon.com","birb.elfenban.de","zeroes.ca","socel.net","misskey.ai","toot.krivokuca.dev","cybervillains.com","scholar.social","activism.openworlds.info","wien.rocks","social.tryptophonic.com","mograph.social","deadinsi.de","podcasts.social","toot.bike","mastodon.csparker.uk","hidamari.apartments","religion.masto.host","mastodon.express","novoa.nagoya","llarian.net","mastodon.uk.com","pon.ee","toot.theresnotime.io","urbanists.social","social.horrorhub.club","eupolicy.social","social.teci.world","social.linux.pizza","brignell.co","mstdn.sheehanmiles.com","mastodo.fi","social.politicaconciencia.org","lile.cl","functional.cafe","tooting.ch","mastodon.creativegamer.net","e0ac-95-141-21-241.ngrok.io","mastodon.comwork.io","mastodon.xyz","beta.mstdn.cf","motley.club","tiny.tilde.website","mastodon.la","awoo.fai.st","blacktwitter.io","mastodontti.fi","xantronix.social","mastodon.coffee","dltq.org","freeradical.zone","queer.af","vis.social","forked.io","mastodon.sdf.org","mastodon.cloud","mastodon.green","shitposter.club","social.tchncs.de","illuminada.io","tkz.one","bluestar.social","qoto.org","nemushee.net","photog.social","birdsite.tcjc.uk","squad.town","todon.eu","greendragon.pub","pl.kitsunemimi.club","tenforward.social","eveningzoo.club","mastodon.fraize.com","nicecrew.digital","toot.nclf.net","mstdn.science","yorkshire.social","gearlandia.haus","mastodon.vlaanderen","raru.re","kysocial.org","free.burningpixel.net","mastodonmusic.social","masto.ashfurrow.com","zirk.us","layer13.p7.co.nz","tdd.social","norden.social","itdev.social","home.social","tech.lgbt","a.n0id.space","mastodon.online","merveilles.town","koyu.space","fediverse.tv","mstdn.ca","mastodon.lol","social.mochi.academy","lor.sh","toot.community","hcommons.social","dosgame.club","kafeneio.social","mastodon.gamedev.place","sonomu.club","kirche.social","front-end.social","toot.party","sciencemastodon.com","mastodon.com.br","ravenation.club","social.transsafety.network","uwu.social","ruhr.social","booktoot.club","theor.io","queer.party","fed.nanao.moe","social.main-angler.de","bbs.kawa-kun.com","bookwyrm.social","fedi.circuitlocution.com","clq.im"]
0

