HTTP/1.1 200 OK
Connection: close
Transfer-Encoding: chunked
Access-Control-Allow-Credentials: true
Access-Control-Allow-Headers: Authorization, Content-Type, Idempotency-Key
Access-Control-Allow-Methods: POST, PUT, DELETE, GET, PATCH, OPTIONS
Access-Control-Allow-Origin: *
Access-Control-Expose-Headers: Link, X-RateLimit-Reset, X-RateLimit-Limit, X-RateLimit-Remaining, X-Request-Id
Alt-Svc: h3=":443"; ma=86400, h3-29=":443"; ma=86400
Cache-Control: max-age=0, private, must-revalidate
Cf-Cache-Status: DYNAMIC
Cf-Ray: 767788d07913b9ae-BRU
Content-Security-Policy: upgrade-insecure-requests
Content-Security-Policy-Report-Only: default-src https: data: blob: ; object-src https: data: 'unsafe-inline'; style-src https: data: 'unsafe-inline' ; script-src https: data: 'unsafe-inline' 'unsafe-eval'
Content-Type: application/json; charset=utf-8
Date: Wed, 09 Nov 2022 15:20:48 GMT
Nel: {"success_fraction":0,"report_to":"cf-nel","max_age":604800}
Permissions-Policy: interest-cohort=()
Referrer-Policy: same-origin
Report-To: {"endpoints":[{"url":"https:\/\/a.nel.cloudflare.com\/report\/v3?s=YeqeeFCHp%2FcO6brPRaGylgkShsDHQALiWr5viotXQ2k6ABvkCQZ4ZDAkQerAgmKiGtTr0Z%2FCeK8LYPUpCqjOxrECUQF8jk%2Bbf21CdQfay5h44FzdaVGWO3HvksLRba9CCdn4WPVbLTgpuaI%3D"}],"group":"cf-nel","max_age":604800}
Server: cloudflare
Strict-Transport-Security: max-age=63072000; includeSubDomains; preload
X-Content-Type-Options: nosniff
X-Download-Options: noopen
X-Frame-Options: DENY
X-Permitted-Cross-Domain-Policies: none
X-Request-Id: FyXzwSZXY-Pmq_f4DgAi
X-Sso-Wat: You've just been SSOed
X-Xss-Protection: 1; mode=block

18372
["friendica.a-zwenkau.de","pl.uwu.is","schleuss.online","social.van-hemmen.com","mastodon.kaiserflur.de","ikbenpiraat.nl","tabletop.vip","lonestar.chat","savageworlds.social","glasgow.social","to.any-key.press","mastodon.nogods.be","vicedomini.cloud","hulla.hu","cast.samsai.eu","irl.dog","astronomy.city","mastodon.partecipa.digital","secretbearsociety.org","inuh.net","mastodon.nerdlings.net","exploit.social","fedi.lynnesbian.space","leadslinger.org","mastodon.heavymusic.rocks","silverheart.social","pleroma.brzozow.xyz","social.riversouldiers.dk","utopia.cool","www.kanoa.de","remnant.social","mastodon.1in1.net","lily.network","sua.anarkis.net","djsumdog.com","mastodon.onepointzero.com","mewitoot.de","video.snug.moe","imastodon.org","masto.tejas.wtf","dragon.style","mastodon.nzoss.nz","letsalllovela.in","skunk.agency","friends.grishka.me","brettspiel.space","fedi.neuwirth.priv.at","until.cloud","social.audiovalentine.com","pxl.mxhdr.net","craftbeer.social","social.zlatko.dev","ryanthomas.org","mstdn1.h3z.jp","fedi.vern.cc","lemmy.perthchat.org","fedi.lewactwo.pl","mstdn.misoni.me","sometimes.social","msk.pedrocx486.club","activism.openworlds.info","mugicha.club","abolish.social","benehomini.social","mastodon.stuttgart.international","mk.shiro.ink","mastodon.lb.minixer.com","social.wake.st","pl.steppe.club","0x3c.pl","social.eyluldogruel.com","social.yampp.de","retr0.id","tomitodon.huideyeren.info","vonsee.de","misskey.na2na.dev","social.kef2.net","social.raccoon.college","thewallsofnight.com","quasselkopf.de","sociala.me","rojogato.com","topic-master.com","social.noordstar.me","mitra.social","pl.fediverse.pl","relay.berserker.town","fedi.vituperio.xyz","social.ellijaymakerspace.org","akkos.fritu.re","mstd.animax.moe","my0.net","hi.moe.tips","lejaua6.club","mrezha.wicker.nz","odenwald.social","huby.infozoo.de","ni.hil.ist","misskey.ranranhome.info","mastodon.blueskycommunity.net","tenpenny.network","extropian.net","foralltime.icu","m.cmx.im","mastodon.nl","fedi.astrid.tech","social.transsafety.network","ostatus.lardbucket.org","juick.com","mastodon.tekdmn.me","social.fabean.xyz","inherently.digital","oslo.town","pogging.fish","mstdn.cuezakuisgodofthe.world","social.uden.ai","were.social","amenti.eu.org","social.c-r-t.tk","arachnid.town","pleroma.pt","m.jippi.dev","youjo.love","friendica.jacobandersen.dev","mk.nixnet.social","pixel.fk.ms","proyectozero.org","arousal.support","social.travisshears.xyz","mastodon.habets.dev","social.californialocal.com","mspsocial.net","mastodon.alienlebarge.ch","flownative.social","mastodon.libretic.fr","toot.cat","social.slat.org","gp.tsukimi.club","wuff.space","fedi.yuka.dev","anosdesiertos.love","talk.flatline.online","mastodon.world","badgay.net","social.saufpark.tv","m.dogcraft.cn","abend.social","angrytoday.com","1210.nl","gravure.club","gazette.live","social.inzeiten.de","friendica.djan-gicquel.fr","tuiter.rocks","mstdn.guru","humble.cafe","tyrol.social","mytoot.de","social.data.coop","wireless-iot.social","public.mitra.social","religion.masto.host","gorone.xyz","letallmortalfleshfindtheirvoice.social","masto.evelynyap.com","data-folks.masto.host","friendicarg.nsupdate.info","mastodon.egroc.de","grove.cyberdruids.club","mstdn.res.ac","adney.land","sun.minuscule.space","social.nvk.pm","systerserver.town","homo.dev","dib-social.bewegung.jetzt","netmonkey.pictures","ocf.masto.host","social.jpi.io","unperson.us","mistodon.cloud","friendica.ungzeit.de","kino.kompot.si","linuxrocks.online","mastodon.g2od.ch","spectra.video","digforfire.org","wei.mentalswarf.com","mastodon.geneticjen.com","osa.tepewu.pl","mastodon.eric.ovh","kokonect.link","mastodon.skorpil.cz","aboring.space","sns.scwhost.org","spaghettimonster.church","cldsrv.duckdns.org","mastodon.bensmith.uk","mstdn.axtch.net","nightly.fedibird.com","bbbdn.jp","social.ariona.fr","relay.libranet.de","alongtheray.social","toot.chalec.org","mk.szkod.ovh","freehub.space","worldkey.io","m.chars.jp","amastodon.uk","social.furry.nz","im.allmendenetz.de","stop.voring.me","anarchydica.net","cornichon.me","talking.dev","mstdn.mk39.xyz","soc.gsg.live","kiritan.work","me.its2.fun","mastodon.fediverse.land","mato.social","starflower.space","social.meissa-gmbh.de","social.strandundmeer.net","social.hardlimit.com","sfba.social","pl.gamers.exposed","saturno.com.ve","kusu.icu","m.heine.xyz","atsuchan.page","libido.pictures","varishangout.net","helvede.net","mastodon.thentrythis.org","ramen-fsm.eu.org","social.grml.de","cybervillains.com","social.mofu2charger-listenradio.net","toot.theresnotime.io","kemoner-don.tokyo","social.here.blue","thotsofa304.club","7td.org","raru.re","2to2.xyz","myasstodon.xyz","atomicpoet.org","hota.hirachon.otakan.jp","gnusocial.net","qoto.org","pl.nudie.social","pix.solarpunk.moe","schykle.com","pixelfed.de","mk.shatteredpalisa.de","pleroma.oook.fr","volcanocoffee.monster","jumanji.co","social.netzdienst.eu","social.murf.org","soc.pierobosio.info","buildthatwallandmakeamericagreatagain.trumpislovetrumpis.life","movsw.0x0.st","magicalmirro.red","researchbuzz.masto.host","0x40.au","social.cologne","socialnotwork.net","rubi.gd","dizl.de","whoneedsabudget.cheap","body.social","meta.masto.host","pix.diaspodon.fr","represent.social","pleroma.lundgrensjostrom.com","socnet.supes.com","idiomdrottning.org","meteo.social","plume.pullopen.xyz","friend.online-erfolg.ch","tukkers.online","comfy.social","pieville.net","mastodon.vapronva.pw","social.ornella.xyz","fediverse.projectftm.com","lsbt.me","wallflowersocial.club","social.johnassel.de","offworld.fedisonic.cloud","rodnoc.xyz","masto.glorious-space.eu","sociable.cafe","mastodon.wssmagazine.com","mstdn.ht164.jp","fr.readthefinemanual.net","pixel.gruene.social","social.shadowkat.net","masto.kansanvalta.org","mastodon.the-orbit.net","miki.live4you.one","podworko.fidura.waw.pl","manx.social","masto.bobbybasement.noho.st","lainlewd.me","skynate.net","techspace.social","arks.social","northeast.one","tube.oldkid.digital","k8s.social","layer8.space","pleroma.nobodyhasthe.biz","geiger.ee","toot.cafe","kafka.icu","suma-ev.social","caffeinated.social","pleroma.otter.sh","mk.gabe.rocks","rdrama.cc","mstdn.osfree.org","anvil.social","u.xa0.uk","toot.yukimochi.jp","frennet.xyz","mastodon.ryotak.me","gochisou.photo","wolfgirl.bar","toot.aquilenet.fr","masto.uk","craftodon.social","anime-titties.com","mamut.tic-ac.org","blumpus.com","nx12.net","www.videoneat.com","xn--y9azesw6bu.xn--y9a3aq","moparisthe.best","social.lightlyseared.online","kokt.club","pleroma.fedi.bub.org","micro.mkp.ca","mastodon.myfed.space","kirakiratter.com","engineered.space","mk.slipfox.xyz","pixelfed.uno","skull.website","mstdn.chitose.org","pixelfed.social","mastodon.room409.xyz","themepark.social","corgi.social","ap.ketsuben.red","pl.tkammer.de","snaggletooth.life","m.daize.xin","bvp.me","lawfedi.blue","social.adlerweb.info","m.uuu.moe","mstdn.genbu.eu","social.inex.rocks","mstdn.mini4wd-engineer.com","im.irithys.com","breezy.my.to","echoes.stolen.day","social.prepedia.org","mendeddrum.org","otter.tube","pod.yargl.com","masto.fdlibre.eu","libretooth.gr","toot.plus.yt","fedi.snepi.space","mastodon.dotorg.org","mastodon.cardina1.red","mastodon.mauve.moe","m.legrand.im","social.kartoffelcheetah.eu","gast.social","paws.moe","social.evilcyberhacker.net","greendragon.pub","culturaeinnovacion.social","toot.re","plr.inferencium.net","sysad.ninja","m.dhosted.io","social.yesterweb.org","pleroma.debian.social","someone.elses.computer","troet.crynet.one","bonequest.net","joingeeksocial.com","social.undeadnetwork.de","social.kjv.online","rafting.io","ubiqueros.com","plagu.ee","line.yamanote.tokyo.jp","mstdn.love","freifunk.social","pantherx.social","impeccable.social","peoplemaking.games","setl.ist","demoarts.social","andlang.me","pleroma.noellabo.jp","kpop.social","masto.astrra.space","developersgonewild.com","social.walterebert.com","paymentbanking.eu","mastodon.hamster.science","test.fedi.moe","grindcore.ch","mstdn.plusminus.io","mast.virtuallyhillbilly.com","xd.trispadsmit.com","faithcollapsing.com","social.simcu.com","p.tkw.fm","mstdn.rukin.me","fedi.xinu.me","pleroma.narrativerry.xyz","bitcoinhackers.org","rag.dog","fedi.kcore.org","redpanda.pics","m.butt.dev","mastodon.c99.org","mastodon.hfranco.dev","peertube.stream","social.suffocating.org","under-bank.blue","spinster.xyz","vindi.ca","mellified.men","dragn.gay","social.bim.land","misskey.u0conveni.club","bildung.social","mastodon.mindlesstux.com","write.nobodyhasthe.biz","jkfd.de","gladtech.social","m.bit-friends.de","blog.swansinflight.nz","dftba.club","democord.masto.host","qnmd.info","social.mootech.eu","soapbox.koles.tech","mastodon.chotto.moe","catcatnya.com","live.relict.space","stream.ozoned.net","social.sattvalife.ru","chirp.enworld.org","mastodon.cllctv.net","handicapped.tk","friendica.bachgau.social","msk.porubu.com","social.europlus.zone","fex.techbio.eu","mastodon.puddle.farm","sandbox.skoji.jp","gorf.space","popura.ch","social.rt4mn.org","mastodon.librelabucm.org","nsfw.lehtiin.eu","mastodon.cisti.org","mcnamarii.town","akko.wtf","ovo.st","social.theredcaps.net","plk.me","mastodon.maescool.be","mastodon.tojo.tokyo","nca.aqualitore-lily.com","whitespashe.uk","shadowland.social","mastodon.xyaren.de","lorenzi.one","bibly.com","allships.run","masto.masto.com","chavie.masto.host","fikaverse.club","social.lb1a.de","network47.net","thebene.fit","mastodon.radicalityincident.com","lebe.gg","starbase80.wtf","social.jakob.space","umaskey.net","nfld.me","mastodon.esmevane.com","topspicy.social","tardis.world","social.chadwaltercummings.me","mastodon.exp0.ml","pleroma.primitivebits.com","mstdn.fujii-yuji.net","tooteam.potchan.org","social.nyerm.com","pixels.stormgrass.com","makito.me","social.labr.online","toot.pt","stonerkitty.monster","social.yl.ms","mastodon.bgzashtita.es","mastodon.masip.cat","pixelfed.eu","otoya.space","social.wxcafe.net","august-don.site","jergefelt.se","mastodon.audiophilestyle.com","timetheft.social","misskey.twink.ink","net.kiobu.dev","mk.possums.xyz","photog.social","mastodon.b0rke.de","left-tusk.com","loftypancake.masto.host","artisan.chat","dotgr.id","social.canony.xyz","mstdn.cnova.de","blogs.linux.pizza","rheinland.social","lediva.masto.host","boitam.eu","morse.social","earthclub.one","mstdn.eh5.me","aipi.social","thegem.city","snowdin.town","patchouli.today","social.joschu.ch","hub.libranet.de","mastodon.caille.fr","tv.anotherbloody.com","thepit.social","mdn.nate601.me","mu.zaitcev.nu","aspiechattr.me","social.3rensei.xyz","workaholic.cloud","cock.fish","pokemon.men","watch.thepolarbear.co.uk","tiz.social","mstdn.philia.work","fedi.slipfox.xyz","penguicon.social","va-11-hall-a.cafe","outrider.xyz","smile.brandonage.xyz","social.v.st","pleroma.microblog.se","amble.quest","oldbytes.space","blob.cat","toot.monocursive.com","ertona.net","thicc.horse","gingadon.com","xn--49ap3c.xn--y9a3aq","social.retronerd.at","pl.anon-kenkai.com","pleroma.tiure.im","chickenfan.club","thesix.life","pleroma.microkod.xyz","tdd.social","bdx.town","skeleton.cool","mastodon.grants.cafe","ruhr.social","tw.9tail.net","pixelfed.photos","social.0ko.me","video.ploud.jp","seaswallow.me","zotum.net","masto1.100flowers.tech","china.al","universe.d3ds3c.net","mastodon.bluecatnet.work","headcannon.xyz","brighteon.social","omochi.xyz","thebunnyden.nohost.me","xarxamontgri.masto.host","mastodon.dcreager.net","flipping.rocks","erratic.cc","pawlicker.ddns.net","laserdisc.party","akko.within.website","paxation.info","ellenburg.computer","merlion.social","simian.rodeo","verumsocial.com","alpaka.social","social.tabletoptavern.online","3dart.social","pug.social","personk.com","vocalodon.net","federation.krowverse.services","mastodon.qapp.cloud","mastodon.glibre.org","mastodon.simounet.net","relay.mastodon.fun","mstdn.kemono-friends.info","ignifi.social","misskey.girak.net","nebbia.fail","nerdica.net","bihlink.com","mastodos.com","social.daspr.io","mstdn.at","misskey.sharivegas.com","snacka.org","dashuo.org","masto.therealblue.de","hacksrus.xyz","inari.click","m.pupu.moe","cybersecurity.masto.host","pl.brodi.me","cuche.cc","deadnaught.andersonstoolshed.com","wobscale.social","seacow.social","gameliberty.club","mastodon.murkworks.net","mstdn.schoolidol.club","friendica.philipp.info","lounge.fan","mastodon.triggerphra.se","kurry.social","masto.chronos-tachyon.net","social.oupsman.fr","mstdn.anqou.net","wyrms.de","rogersfam.co","misskey.04.si","mastodon.oliverfalvai.xyz","tea.cplus8.com","relay.social.tigwali.fr","arkham.cafe","gs.leftic.club","mstdn.netpro2k.io","epitaph.noize.guru","pleroma.judydev.net","mastodon.fedi.bzh","furfag.de","pleroma.doingyourmom.club","mastodon.nervesocket.com","conversafiada.net","social.esmailelbob.xyz","justabit.social","yamabi.co","mental.camp","chancellor.social","blurts.net","social.mashed.cloud","mastodon.antaresx.ch","nakamoto.social","social.degrowth.club","mastodon.holeyfox.co","petroskowo.pl","social.vampirebbs.org","krefeld.life","vanderwarker.social","mtd.social","pl.lain.sh","fed.uninsane.org","mk.longyap.name.my","x0r.be","hameln.social","social.matej-lach.me","linksgruenversifft.social","goyslop.cafe","masto.krashboyz.org","social.piperrak.cc","libereco.social","toot.irrpfad.de","letus.inspiredlife.fun","space.rick.gr","wybt.net","scorpion.social","remembertheend.com","mastodon.hams.social","mk.sysk-work.net","masto.rocks","social.sailor.cat","boosterfive.com","fellies.social","novoa.nagoya","mst3k.interlinked.me","h1v3.de","social.ruthenic.com","minidisc.tokyo","freezepeach.online","social.tchncs.de","dudu.capricom.info","mastodon.rockhost.se","social.ebf.io","mastodon.blackblock.rocks","hayu.sh","ram.lgbt","2ot.fun","bruder.space","gomastodon.cz","social.tinygo.org","social.talesofmy.life","jasonrobinson.me","myopic.one","pixel.artemai.art","social.plzpet.dog","m.mtjm.eu","mastodon.lhin.space","social.agb-web.de","poster.place","misskey.weebcouncil.online","rigcz.club","iddqd.social","mastodon.design","lolic.at","misskey.gothloli.club","catdon.app","2m.cutls.com","zulu6.com","instanzfreun.de","mstdn.life","mastodon.xylinvale.space","screenwriting.space","himk.am","toot.zerojay.com","bbs.keinpfusch.net","pleroma.ga","social.nikos410.de","mastodon.wivodaim.net","geekcompass.com","pouque.net","kozlovsky.institute","mewvinerse.masto.host","nullwhere.social","mastodon.atikoro.net","mastodon.malmorrow.com","lsngl.us","mastodon.edelmann.bond","freak.university","monocles.social","universeodon.com","gn-tronics.dev","cloudfiction.social","toot.moe","nonexiste.net","labonneheure.ch","efdn.club","master-feed.net","social.feurious.com","koyu.space","misskey.pantasystem.com","comfyboy.club","breezy.cyou","mk.himbeer.me","mastodon.comwork.io","cutiehaven.club","surfin.dog","mastodon.craftcat.dev","mastodon.sbpk.fr","surf.cyberspace.club","mastodon.acc.sunet.se","fediverse.one","toot.cleeb.net","tassaron.com","walkman.social","diabetes.masto.host","social.pueseso.club","mastodon.wallera.computer","mastodon.opportunis.me","post.mrotek.xyz","oceanplayground.social","m5y.usuyuki.net","5fb3f2bb.nip.io","trebo.chat","mymastodon.uk","pl.comfysnug.space","mastodon.kn-cloud.de","fenetre.dev","relay2.mastodon.ml","treecast.com","social.pixie.town","chitter.xyz","supervolcano.angryshark.eu","mastodonapp.uk","bluetoot.hardill.me.uk","uss.killiwamps.com","betterthantwitter.com","nya.house","xoxo.zone","mstdn.binarytango.com","pleroma.dragonborn.app","pokorny.ca","fedi.maneisacutie.club","mstdn.gots9713.xyz","junebug.masto.host","zone.dora.im","bozgor.org","federation.ninetiesmysteri.es","bofh.social","skinnyver.se","mastodon.top","girevik.su","social.overlappingmagisteria.org","zalem.city","sigmoid.social","social.fuzzyoverlords.org","mastodon.nosink.eu","social.hanntac.net","fedi.intkos.link","comics.town","mona.do","cocaine.moe","chaosphere.hostdon.jp","lasersword.club","mastodon.cipherbliss.com","code4lib.social","mastodon.ninja","pl.craftplacer.moe","frmsn.space","mastodon.sphericalk.at","ursa.cafe","p.eta.st","social.stlouist.com","social.goethe12.de","pleroma.anduin.net","pleroma.schuerz.at","www.i-kaohsiung.com","social.deadsuperhero.com","tea.codes","freeradical.zone","esperanto.masto.host","tnd.lol","mastodon.pl","jako.social","mk.outv.im","dolphin.town","mathstodon.xyz","xn--thelnd-eua.land","econresearch.org","nnia.space","video.tedomum.net","derpsin.space","dindon.one","shelter.moe","social.bloc.black","bremen.team","mastodon.lukem.net","coq.social","red.niboe.info","maston.grupotd.nat.cu","mastodon.wurzelmann.at","pixelfed.tokyo","v2.nyoki.club","urchan.org","deepspace.social","kawen.space","lgbtqplus.social","mastodon2.juggler.jp","mastodon.elte.hu","ungoverned.social","cuscuz.in","social.singing.dog","glitch.taks.garden","kitty.town","mastodon.kigurumi.fans","privacyhub.xyz","flausch.social","dltq.org","moe.cat","imastodon.net","mastodon.potager.org","mastodonserver.eu","karlsruhe.social","social.zapletalovi.com","social.lsnet.eu","trailblazer.social","indymotion.fr","liberal.city","xn--baw-joa.social","esquite.mazorca.org","social.froonix.org","social.media-techport.de","queef.social","mastodon.motcha.tech","ussr.win","stemislife.org","mastodon.libre-entreprise.com","social.ersei.net","mstdn.sheehanmiles.com","pegelinux.top","mastodon.richmorrison.com","notorious.gay","vuju.com","toot.wales","spla.mastodont.cat","social.futurnumerique.com","pl.nikotile.xyz","social.milksoup.net","vulpine.club","muenster.im","chatter.llamarific.social","social.nvdc.ovh","bocchi.social","hagew.blog","biscuit.town","clowntown.app","cliff.social","social.birdsonbicycles.racing","joohanv.me","nightshift.social","kvlt.zone","pleroma.chillout.chat","watadon.com","rva.party","puntarella.party","indiepocalypse.social","alice486.com","groundpolis.app","mastodon.hawaga.org.uk","social.mueller-post.de","aircrew.rocks","misskey.t-asa2000.net","blimps.xyz","clq.im","bunny.blue","nemushee.net","tusk.sfunk1x.com","lila.menac.at","pl.apathy.tv","social.lunasqu.ee","pleroma.langmerah.net","mstdn.one","mastodon.ecnelises.com","moc.d-x-b.com","sociale.network","masto.plus","img.sturtz.io","lolison.top","mastodon.zone","frentalk.com","mastodon.hydrosaas.com","squid.cafe","storo.social","m.yihao.moe","dogodki.kompot.si","weburbanists.com","pod.appliedmachine.app","wandzeitung.xyz","vandrare.page","social.savemy.name","mstdn-amadeus.tech","pleroma.nylarea.com","battleangels.net","social.phaseshift.studio","melonbread.dev","bittube.social","honey.town","drdr.club","mastodon.xy-space.de","hub.pericles.hu","venera.social","hapyyr.com","mstdn.glorificatio.org","kurage.cc","friendica.chudzinski.com.de","misskey.dokodare.ovh","feedbeat.me","zeroes.ca","t.cly.wtf","fediver.se","tonybark.com","smallposts.net","neonflux.city","pl.zombiecats.run","wxw.moe","fedi.scd31.com","mas.atmx.ca","mangoranch.lol","goblin.technology","xtaldave.net","nuked.social","mstdn.haun.jp","tty0.social","pl.savant.so","one.telmina.com","pupy.cafe","mastodon.dahlstrand.net","undergamer.quest","lgbt.pm","breakpoint.cafe","m.afop.tech","post.lurk.org","101010.pl","dads.cool","fairy.id","the.crabdance.ca","hub.vahfoom3iquahfah.infinitedisk.com","dogno.se","miss.voided.ee","p.bozolord.ml","cybre.space","plaza.remolino.town","steffes.dev","m.sclo.nl","whitesmokebbq.social","ubuntu.buzz","ilias.church","mastodon.se","vapers.jp","mastodon.star-one.org.uk","ridixy.com","is-he.re","puzzled.cc","liveplatform.ca","elysian.city","eweg.be","s.ovalerio.net","hello.2heng.xin","majak.de","pl.m0e.space","bikeshed.vibber.net","mystic.lgbt","toot.a-ef.org","artsio.com","oldinternet.net","social.mikutter.hachune.net","moytura.org","mastodon.whispr.social","socialturtle.eu","seediqbale.xyz","social.hackerfraternity.org","recurse.social","n-odes.social","eupolicy.social","shitposter.club","netz.darknight-coffee.org","tube.xy-space.de","hungryhacker.com","misc.name","relay.fedibird.com","moresci.sale","m.aqr.af","social.iospace.de","djanzu.tokyo","mas.gordons.gen.nz","relict.one","altoetting.social","jade.moe","is.badat.dev","stoopid.club","archaeo.social","social.creatureofthehill.com","social.chinwag.org","drk.network","xn--lofll-1sat.is","msk.ilnk.info","blog.fulda.social","hyperpla.net","theopjones.com","misskey.noellabo.jp","frens.mahodou.moe","hub.phanisvara.com","social.datenkastl.de","toot.matereal.eu","gangstalking.services","mn.tlf.pw","m.zuiho.moe","mastodon.linuxistsuper.de","climatejustice.rocks","shitpost.cloud","kamu.social","pleroma.soykaf.com","cztwitter.cz","social.freetalklive.com","plma.plus.st","dudu.best","toot.hoyle.me.uk","tiggi.es","soc.7thmagic.net","social.dev-c.at","masto.1146.nohost.me","friendica.heikosblog.eu","crlf.ninja","sysadmins.zone","fish-404.club","morse.haus","mastodon.fedisaur.us","genart.social","incidentally.social","sozen.network","mastodon.thearcanum.net","toot.community","foxtail.ooo","socialclub.nyc","muenchen.social","astral.camp","social.thierrytalbert.fr","clyez.city","refusal.biz","pouet.couchet.org","mk.togen.xyz","lizards.live","b-c.social","deadinsi.de","honk.tedunangst.com","climatejustice.photos","friendica.vrije-mens.org","social.jakecoffman.com","friends.polli.social","birdity.club","mastodon.gruifor.eu","plamo.social","otogamer.me","toot.si","blockriot.com","mastodooooooon.xyz","tubbycats.club","mastodon.juggler.jp","mstdn.husku.net","zusammenhalt.de","jit.social","spacey.space","social.benjamin-westland.de","lehrerzimmer.social","mastodon.blessedgeeks.org","tooot.im","social.cool110.xyz","letsrulethe.world","mastodon.yshi.org","ak.lightnovel-dungeon.de","sully.site","isle8.uber.space","toot.mattedwards.org","videos.im.allmendenetz.de","stinkytoot.social","hostux.social","social.nocci.xyz","ansico.dk","pouet.mickaelgillot.xyz","social.eden.one","misaka.ru","relay.minecloud.ro","mk.aetheri.ca","yharnam.singles","bcom.moe","podpro.biz","pix.toot.wales","ruby.social","skippers-bin.com","konvergo.co.uk","social.chilliet.eu","social.jihad.icu","selq.me","dragonscave.space","tilde.zone","social.solibre.de","inkdrop.space","the-pit.uk","conesphere.social","gts.churanova.eu","skyjake.fi","mastodon.jfmblinux.fr","frenetic.ink","social.bitwig.community","chablis.social","wife.town","jawns.club","fedimovie.com","globalwarming.fun","tyazzkey.work","ansible.jshwlkr.info","wyrd.social","todon.eu","social.ewing.au","needsmore.pizza","mastodon.gamedev.place","social.vikshepa.com","blog.writefreely.org","oulipo.social","dtp-mstdn.jp","signs.codes","toony.club","mastodon.zunda.ninja","justjuut.de","chabant.social","crowleyclub.com","mastodon.buzhangjiuzhou.com","social.netzspielplatz.de","sunisky.club","social.hnws.me","cloud-native.social","vod.newellijay.tv","quitter.pl","write.allships.run","ourempty.pub","compostintraining.club","makegame.run","mastodon.metalbanana.net","picto.anartist.org","mastodon.christophfink.com","xn--p1abe3d.xn--80asehdb","m.x4s.io","foo.sx","based.social","social.dev-wiki.de","misskey.id","m.iamkonstantin.eu","social.mat.tl","toots.benpro.fr","mk.vulpes.one","pleroma.elinvention.ovh","talk.stayas.one","freesoftwareextremist.com","blazingopen.space","suchtbasis.de","mi.tkw.fm","pleroma.marussy.com","19hundert84.de","mastodon.huntsvillain.com","social.wideboys.org","d-64.social","mhz.social","ischool.social","sindicato.social","mk.mistli.net","p.umbriel.fr","bildung.royscholten.nl","earfolds.com","mastodon.kerenon.com","toot.bike","misskey.mymte.de","m.kretschmann.social","benign.town","fedi.ml","pleroma.breizh.pm","wordsmith.reverie.club","absolutelyhar.am","goto.fediserve.de","techlover.eu","overbye.dev","kazv.moe","sumanko.ml","030.me","pl.ebin.zone","friendica.gidikroon.eu","frankfurt.social","tooting.ch","phpc.social","mutual.tls.zone","pleroma.dead10ck.com","blacktwitter.io","puti.gspot.lol","80percent.social","toot.azadehafzar.ir","mcd.dk","happytobehe.re","news.twtr.plus","kayii.goe.land","social.dbot.dev","machines.social","hidamari.apartments","fedi.xerz.one","toot.yosh.is","misskey.rdpstudio.top","nitiasa.com","ohai.social","mastodon.green","gorf.pub","podcasts.social","social.qunn.eu","toot.eick.com","lesbianschool.com","plural.cafe","social.unx.pw","pleroma.pixificial.xyz","mastodon.dragoncave.dev","junkhub.org","msky.h3z.jp","m.rse43.com","augsburg.social","freecumextremist.com","stream.cheeseburger.social","mastodon.wolfpaw.kr","velocipederider.com","mograph.social","feed.vance.land","social.danksquad.org","mastodon.gerkenator.com","metapixl.com","toy.hansaray.pw","universe.feliver.se","monsterfuckers.online","social.int21h.eu","mabe.space","quorum.inumbra.xyz","bigthinking.social","social.tfwnogf.nl","blimey.social","natsu.page","gts.fsociety.social","m.g3l.org","mcrn.one","exercise.cafe","tabletop.social","snabelen.no","internetstuff.xyz","gearlandia.haus","test.m-i.im","social.thiskurt.me","eihei.net","fluffcord.social","onion.social","ypolis.net","misskey.kusoneko.moe","mastodon.bawue.social","masse.xn--qubec-csa.tk","thedreaming.city","exploding-heads.com","ravenation.club","chatterbook.us","eveningzoo.club","polyglot.city","persadon.com","pleroma.reinemuth.rocks","0xfeedc0.de","mstdn.beer","pleroma.gronkiewicz.dev","pl.dira.cc","mastodon.radio","pleroma.foxfam.club","abid.cc","mastodon.yantou.me","s.sneak.berlin","writeworks.uk","mastodon.nixgeek.com","wiki.style","assemblag.es","social.hindelaufen.com","is-a.cat","social.hostpath.de","nerfherders.io","xyzyx.org","kiwi.fuo.fi","wreck.rocks","toot.conrad.cafe","pnk.solar","narwhal.city","pl.nulled.red","beefyboys.win","social.thorjhanson.com","mastodon.grin.hu","v-insanity.com","dcerberus.com","social.joshthomas.dev","open.audio","p.node.pk","nca10.net","friendica.myportal.social","gensokyo.town","mastodon.o3o.icu","social.kramse.org","social.jmizzle.com","dev.brighteon.social","v2.ebano.social","friendica.knowbility.nl","toot.phseiff.com","onlyfeds.cc","social.datalabour.com","vernunftzentrum.de","sunbeam.city","groomlakeroad.com","riddly.rakka.tk","ludosphere.fr","mastodon.tech-nico.de","mastodon.astrr.ru","seal.cafe","yoitsu.moe","kitty.social","mastodon.kf0are.net","mstdn.ikebuku.ro","social.legrand.im","mastodon.wilsonxia.cn","bne.social","mastodon.crossthestreams.blog","arathe.net","ioc.exchange","torlaz.online","space.jeroenvd.nl","social.da-am.com","idtech.space","social.jesuislibre.net","noagendasocial.com","beta.mstdn.cf","dasnetzundich.de","fedi.koyu.space","josh.tel","top.ofthe.top","pix.oldkid.digital","fog.highspirits.games","ostatus.taiyolab.com","mastodon.ericlathrop.com","plasmatrap.com","kcl.academy","misskey.ai","social.woefdram.nl","mastodon.transneptune.net","embassy.social","ser.endipito.us","lingo.lol","literatur.social","mastodon.gramschladen.de","shavingcream.online","masto.donte.com.br","artoot.xyz","comerocudequemestalendo.com","magnetic-ink.dk","jvpiter.net","meld.de","toot.krinetzki.de","r2r0.de","o3o.ca","social.atypique.net","social.finkhaeuser.de","mapstodon.space","fediverseis.fun","pleroma.tilde.zone","www.bradmcgarr.me","octodon.social","social.shrimp.faith","mastodon.zeteo.me","nocoolnametom.com","herd.bovid.space","p.concho.bar","mast.ecohost.ie","fantashley.dev","docviper.de","ricard.social","social.eboboserver.ru","pfadi.social","toot.morikka.me","tutut.delire.party","redliberal.com","mastodon.ocert.at","tfl.net.pl","hakodon.cf","social.apcn.nz","m.moec.top","writee.org","abstract.town","sleeping.town","is.aaronbsmith.com","raxx.la","mastodon.csparker.uk","flagada.org","fedi.reimu.info","paws.town","cowfee.org","tube.undernet.uy","scalie.business","rustedneuron.com","pxlmo.com","chat.skiddle.id","mastodon.sdf.org","insolent.us","soapbox.alphasoft.org","social.globalpirates.net","toot.supremesyntax.com","cutout.media","bunglers.it","misskey.chiffon-sepxipl.com","mastodon.sysctl.io","bonn.social","pleroma.skyshanty.xyz","clacks.link","shiina.cafe","skj.ca","jenna.masto.host","salon.fika.moe","masto.werefox.cafe","m.gtk.pw","xn--zck4ad5f2e.xn--q9jyb4c","backyard.cloud","kampftoast.de","1234.as","faerghus.today","friendica.andreaskilgus.de","ostfrie.se","jauntygoat.net","shitpisscum.mooo.com","potate.space","ooe.social","kopfkino.social","pixel.geneticjen.com","twipped.social","zetsubou.ryona.agency","icioulaba.tk","iscute.moe","fedi.9til.de","mastodon.creativegamer.net","f.haeder.net","usne.social","ap.samueldr.com","hikoukidon.jp","fediverse.pl","mastodon.li","mastodon.hackerdrinks.social","mastodon.sk","msk.hoshisaki-h.com","testing.microblog.pub","tastingtraffic.net","cthonic.club","vid.pretok.tv","strasser.wien","hacky.town","social.kindbook.us","mastodontti.fi","ned.masto.host","videos.trom.tf","plaza.vaporpolis.net","fans.sonichu.com","banjo.town","mastodon.social","memo.arcades.agency","social.ra-phi.ch","social.unitoo.it","mstdn.elseifnull.xyz","bungle.online","spiral.sh","toot.leuchtetgruen.de","social.machauer.dev","tooter.social","ipsw.uk","sy.nthia.dev","pleroma.cantonia.org","node9.org","polaroid.absturztau.be","social.pmj.rocks","masto.kreks.nl","lazybear.social","graz.social","soc.webair.xyz","hub.hoteldaan.nl","mastodon.cct-cpc.org","w9r.social","mastodon.lavergne.online","wizzzard.online","kirche.social","posting.lolicon.rocks","a.n0id.space","satzfetzen.de","www.social.tromsite.com","f.reun.de","postpandemicparty.org","video.omniatv.com","social.ballpointcarrot.net","lesbian.energy","fedi.home.ctu.cx","pleroma.interhacker.space","neonsoup.xyz","glindr.org","social.infinity.garden","mastodon.lt","ahlers.xyz","mstdn.klamath.jp","poliverso.org","mk.disqordia.space","social.plux.wtf","social.integritymo.de","rubber.social","ole.wine","four-nine.club","nrw.social","mstdn.otyakai.xyz","propulse.club","takeko.monster","senigallia.one","andyvgrsocial.mywire.org","me.iamnate.net","planet.moe","mstdn.ghastr.com","mastodon.indiegames.online","oraclearm.nsupdate.info","lemmy.schuerz.at","vancity.social","toot.inkwell.space","mastodon.technology","together.chaoyu.us","video.blast-info.fr","mastodon.chrisbol.nl","mstdn.rinsuki.net","genomic.social","estrogen.network","stream.labr.online","pl.gnu.moe","social.ei8fdb.org","mastodon.dmgd.monster","neckarwie.se","cryptotooter.com","mastodon.acc.umu.se","ente.fun","natehiggers.online","comm.network","xeno.chat","social.b10m.net","idolheaven.org","social.odayacres.farm","masto.namwen.me","mentalhealth.social","pleroma-in.ouda.space","c18.masto.host","mastodon.uk.com","notacult.social","fv.cottongin.xyz","misskey.cf","karlspace.masto.host","yorkshire.social","toot.y-y.li","charade.social","playground.bonfire.cafe","nixnet.social","exile.social","hub.heraut.eu","net4sw.com","cawfee.club","dair-community.social","tooting.intensifi.es","mk.shc.kanagawa.jp","social.franssen.xyz","social.diekershoff.de","friendica.hellquist.eu","social.kylebronsdon.com","social.xphera.eu","omnific.one","moe.pastwind.top","social.unextro.net","antisocial.ly","botta.social","toot.fedilab.app","fullyautomatedluxurygayspacecommunism.party","huaren.social","comm.cx","social.mnh48.moe","frikiverse.zone","mijn.masto.host","social.prieb.me","433.world","fimidi.com","witches.live","toots.social","federate.social","thevillage.social","gaminginthe.cloud","medibubble.org","social.careyscloud.ie","matthewedavis.online","streamz.ca","heidel.berg.social","social.researchanddestroy.technology","social.freeipad.info","xn--y9a6bah4ck.xn--y9a3aq","blog.serverok.pl","rodina-sucha.cz","social.pumpitbetter.com","ausglam.space","mastodon.jadin.me","pler.garrison.beer","fedi.safewebbox.com","fedi.artcspgs.nohost.me","podlibre.social","mastodon.lubar.me","unnerv.jp","col.social","madost.one","ghetti.monster","mastodon.chriswiegman.com","masto.gspot.lol","japix.schuerz.at","peertube.uno","social.pseudo-whiskey.bar","thebull.app","social.pixelgesicht.de","social.chatty.monster","dain.moe","maki.chiba.tw","delaeuforia.com","wizard.casa","gts.superseriousbusiness.org","perkins.pub","yapi.burger.rodeo","social.medusmedia.com","thx.one","urbanists.social","toad.social","fediverse.blog","toot.site","social.lecker.coffee","mastodon.cf","mastodon.d14n.club","mstdn.poyo.me","cyberstorm.one","g0v.social","jaesharp.social","tooters.space","counter.social","gleasonator.com","mieth.social","collapse.cat","woln.eu","stoneartprod.xyz","xyzzy.link","mastodon.1o1.io","pleroma.takeko.cyou","unvaxxed.nl","oran.ski","vran.as","social.anji.nl","cx.cx","hub.volse.no","mastodon.helvetet.eu","md.net-p.org","mastodon.fyksen.me","omoro.info","social.metakaos.space","area51.social","social.lain.day","fedi.skladka.net","pleroma.panoptikum.io","ping.the-planet.space","mastodon.devinck.eu","pleroma.elementality.org","beta.dissident.business","mastodon.cryobyte.net","social.scriptjunkie.us","mastodon.im","brandenburg.social","eay.social","social.odessa.dcomm.net.ua","svrdn.drillion.net","m.alanjames.org","harbour.cafe","nekocave.xyz","social.unnecessary.tech","social.driveby.cool","mastodon.pena.mobi","mstdn.ca","muh.wang","hodltech.com","schutt.social","reco.shrieker.net","social.lainon.life","nangang.travnewmatic.com","social.wolfskaempf.de","autonomous.zone","mastodon.doufen.org","pullopen.xyz","ygo.pub","social.x.caad.one","unkworks.net","moessingen.social","libertaria.space","flowerpot.fyi","glitch.cat.family","vostain.net","democracy.town","dogsex.org","sneed.vip","gyutte.site","pl.serialmay.link","towns.gay","fedi.wien","mosw.work","nitech.online","cyrenesavage.com","pix.fpsource.eu","mastodon.compositecomputer.club","mastodon.westsideblogger.eu","masto.amosamos.net","depixelated.com","hub.debenny.de","uwu.social","twhtv.club","squeak.social","social.bhsnw.com","amor-fati.social","wug.fun","the.floof.rocks","tuusin.misono-ya.info","social.jorisgutjahr.eu","sneed.social","sad.cab","cybar.club","soc.kvet.ch","respublicae.eu","meganekeesu.tokyo","molten.cloud","mastodon.darkou.fr","fedisnap.com","mastodon.owls.io","ajin.la","sorcie.re","mastodon.rosseaux.com","social.skbo.net","odakyu.app","ingwie.me","hub.somaton.com","m.brokep.com","kino.schuerz.at","this.mouse.rocks","my.privacymatters.pro","photodn.net","sb.greenboys.club","mastodon.cartapus.eu","mstdn.jp","s.mikka.md","hub.elemac.fr","social.safestreetrebel.com","jasette.facil.services","pleroma.cafkafk.com","toot.twofirstnames.org","ploen.social","mastodon.corecoding.dev","mastodon.education","mainburg.hallertau.social","dev.dollarvigilante.tv","social.jjohnson.org","moth.zone","social.jmueller.eu","notnow.dev","mastodon.blessedgeeks.com","freesocial.co","acg.mn","mk2.toyoko.in","is.lewd.pm","pleroma.snet.blog","mastodon.atticstudios.be","txs.es","pleroma.hackea.org","mental.social","pleroma.pbb.lc","mstdn-bike.net","kittycat.homes","high.cat","karab.in","waferbaby.com","mastodon.we-cloud.de","sdfn-01.ninjawedding.org","csv.jodh.us","mk.catala.digital","androiddev.social","plume.nogafam.es","mastodon.neilzone.co.uk","georgi.family","social.duarte.vg","misskey.io","unstoppablecode.org","kw.social","pl.panthermoderns.org","relay.101010.pl","larkspur.one","goblinfoot.com","pleroma.nvk.pm","strelizia.net","pleroma.thebitpros.com","fluff.land","bluestar.social","clacson.abiscuola.org","tane.codes","wetdry.world","san-junipero.gimme-sympathy.org","one.darnell.one","upallnight.minnix.dev","illuminada.io","social.sitedethib.com","masto.a0s.de","social.jugendhacker.de","bantha.tatooine.space","saigyouji.cyou","scl.clttr.info","toot.payfrit.com","bluejay.social","undernopretext.social","marzillier.net","glitchbird.com","masto.social","smallcamp.art","amicale.net","mastodon.gsugambit.com","moonbeam.town","pine.cab","turnip.solutions","fedilove.cyou","pixelfed.jascha.wtf","wandel.social","friendica.ironbug.org","mastodon.fkpk.org","loveforlandlords.com","mastodon.zaclys.com","embracing.space","social.epenguin.com","aleph.land","catgirlmeike.eu","fedi.tesaguri.club","str4.com","pleroma.minecloud.ro","donotban.com","social.marzillier.net","mastodon.someotherguy.xyz","mastodon.scot","mastodon.baucum.me","social.p0lymer.net","mastodon.magnox.me","wildebeest.mooo.com","bat.chat","retro.social","brotka.st","social.raindev.org","pleroma.miguelcr.me","pixelho.me","mastodon.vda-group.de","social.rights.ninja","mastodon.spotek.io","wizzards.club","mstdn.home.neso.tech","gp.miku2go.com","social.hispabot.freemyip.com","menteva.ga","manyworlds.fit","xxxxxxxxxx.xxx","mastodon.desord.re","linuxlab.sh","onlycasino.legal","tacobelllabs.net","social.tcit.fr","orwell.fun","plttn.xyz","mstdn.hyogo.jp","tiny.tilde.website","fedi.jmizzle.com","geofront.rocks","stars.eroaward.com","soc.jae.fi","woof.group","ap.ser1.net","hyan.ink","bizkaia.social","socialwagrien.de","mastodon.martinchapman.co.uk","deadreckoning.cc","mstdn.imi.moe","rapemeat.solutions","bruh.homd.xyz","cl.kasma.cyou","s-shinjuku-rail.hostdon.ne.jp","feuerwehr.social","m.trisweb.com","mastodon.surazal.net","fedi.relms.dev","moien.net","schoolforafrica.org","soapbox.impeccable.social","video.netsyms.com","x.melonia.se","friendica.xanderwharts.us","pixel.noff.co","mastodon.namel.fr","mastodon.thewarrens.name","badmoon.fortyoz.org","digitalcourage.video","eatthebugs.social","akkoma.kasma.cyou","d0y.de","refuse2.work","masto.design","kirei.moe","fedi.zettas.space","co.misskey.io","frog.camp","toots.hwl.li","homoo.social","post.wznmickey.com","piraten-partei.social","socnet.softgirl.online","elbmatsch.de","mastodon.randomroad.social","giobu.cyou","social.markwaters.eu","lain.gay","social.cj8.de","chat.noelle.codes","hub.uckermark.social","pleroma.in.th","fedi.fai.st","social.lol","unstable.systems","social.frankreimer.de","argentum.social","mastodon.nu","mastodon.desmu.fr","mastodon.flossir.org","sksocial.ca","mstdn.dgm.pw","comicscamp.club","audiomix.club","freunde.ma-nic.de","home.social","social.artemai.art","0xdevelopers.online","social.okoyono.de","sozialer.irrpfad.de","sp.kub2091.ru","redeyes.club","gts.fedi.tax","muro.undernet.uy","mastodon.xytes.net","ward2.bouvardia.icu","ukiyo.cafe","mb.neurario.com","social.libertyaf.io","faf.social","genau.qwertqwefsday.eu","social.lernortdigital.de","h5q.net","social.tripulse.net","social.fpsource.info","toot.party","pleroma.wolfie.pw","best-friends.chat","rebelbase.site","mastodon.cysioland.pl","mastodon.localecho.net","linke.social","feddit.it","cybercrusade.xyz","isnot.online","focal.social","spanner.works","weirdgone.pro","swiss-talk.net","mastodon.oi7.de","pleroma.glueoh.com","pleroma.salastil.com","mastodon.hardcoredevs.com","mustardon.tokyo","bern.social","solagg.com","social.snopyta.org","la-verite-vaincra.com","mastodon.mit.edu","kisaan.social","mastodon.pointless.net","socialgoblins.club","social.dauen.name","videos.lukesmith.xyz","agora.echelon.pl","freespeechextremist.com","pop.jodh.us","dungeons.social","port.mk","mastodon.fedja.fi","lisp.buzz","mastodon.arch-linux.cz","mk.shrimpia.network","hypr.ninja","misskey.m544.net","friendica.jb-net.us","mastodon.gargantia.fr","lawsplaining.peertube.biz","social.xunil.co.nz","social.vekant.com","cofeti.me","antisocial.fabiojj666.nohost.me","hz.macgirvin.com","primitivebits.social","elekk.xyz","computerhater.club","bitcointv.com","video.vegafjord.me","social.schiessle.org","namelesscitizen.space","misskey.yukineko.me","pixelfed.cafe","mytoot.net","pleroma.echolib.re","ursal.zone","don.gomasy.jp","trouth.eu","social.keda.re","fediverse.xavin.net","red.0x89.de","arktos.social","mastodon.hypnoguys.com","social.gotterfunken.eu","666.glitchwit.ch","mastodon.balamb.fr","near.social","nitecrew.rip","tube.systerserver.net","pomdon.work","ninetailed.space","fedi.dysphoric.space","lonely.town","bitacadie.com","art-software.fr","toot.su","fedi.lesbianforest.club","pnd.mn","toots.roboces.dev","social.sciences.re","social.tsun.co","berlin.social","mastodon.parastor.net","sns.koyu.space","mastodon.opencloud.lu","mastodon.klattgroup.eu","poa.st","syntaxerror.space","campduffel.social","mastodon.lemuspeschel.com","mstdn-jp.site","fri.bitcast.info","hemmer.land","kraud.social","social.troll.academy","fluf.club","mastodon.home.inndy.tw","mpx.social","cornerof.world","pfalz.social","bbq.snoot.com","social.epyisageek.net","photoholics.online","mastodon.jmtr.org","go5.dev","social.cyano.at","pleroma.astralchan.xyz","trunk.mad-scientist.club","toot.dragon2611.net","tube.continja.com","rectongle.net","social.publicspaces.net","rondoalive.xyz","mastodon.im.sb","sonora.radioaconchego.org","4estate.media","toot.kuba-orlik.name","pleroma.atyh.cc","coldrick.me.uk","social.shadowfacts.net","plero.antopie.org","m.loovto.net","weirder.earth","fnordon.de","zeroping.cc","social.thefloatinglab.world","hmm.schichler.dev","social.rtorr.com","mastodon.kitamurakz.com","pancake.place","social.up.edu.ph","handon.club","connect.takebackourtech.org","khajiit.tech","b4udw3rk5.com","snug.town","mastodon.sanboukarasu.io","social.matcha-soft.com","mastodon.rousset.nom.fr","mastodon.macsnet.cz","po.etr.ist","gazouiller.fr","social.anno79.de","youdeserve.space","alfazema.club","mordor.social","orchorde.masto.host","fsoc.lol","mstdn.art","csdisaster.club","social.yharnam.town","social.anufrij.de","yokai.cafe","social.coalition.zone","devin.masto.host","mastodon.fredspieler.com","cocoronavi.net","truthsocial.st","krems.social","social.lukepreston.xyz","status.notcraig.com","the.goofs.space","mastodon.orties.net","akko.kalasarn.se","pizzaf.art","birdsite.wilde.cloud","mein.mikroblog.at","mastodon.yantouer.com","mastodontech.de","nuklear.family","pleroma.wasscher.com","social.bigger6.com","fedi.simonwillison.net","skiddle.network","woblfedi.de","zov.oti.st","mastodon.simulakrum.vpndns.org","social.ssbx.dev","dewp.space","video.ploud.fr","flyaway.city","soc.schuerz.at","social.jacobandersen.dev","federation.p1k3.com","d20.social","click.ba.it","social.flal.net","fedi.technodro.me","social.wildeboer.net","know.me.uk","gts.cybre.ninja","social.zwoelfdreifuenfundvierzig.net","old.mermaid.town","social.dekloo.net","social.yakshed.org","social.thecrow.uk","librenet.co.za","term.social","mstdn.omisosiru.net","cute.is","social.ridetrans.it","scintilla.social","toot.blue","mastodon.hijsselinckx.com","mastodon.floe.earth","hornyjail.pro","dither.ddns.net","waytoomuch.info","lbry.world","hub.brockha.us","microblog.bandersnatch.xyz","10000x.dev","quanta.wiki","appbucket.io","falsy.cat","noc.social","pmth.us","pleroma.maciej.website","social.abraum.de","mastodon.steinernebruecke.de","piaille.fr","flanintheface.com","mastodon.sharma.io","fr13nd5.com","fet.bar","mastodon.matcha-soft.com","nwb.social","5dollah.click","free.gluten.space","video.lincolncyber.com","wubrg.social","pawoo.net","mstdn.vodka","solitary.social","lipsia.casa","matitodon.com","soc.kouett.net.eu.org","mastodon.anzui.dev","smelly.today","social.juke.fr","netmonkey.xyz","social.qownnotes.org","critter.zone","momo.mame.moe","nolineage.com","mastodon.1bit.se","horsegoddess.masto.host","social.laserbeam.productions","pokemon.mastportal.info","eupublic.social","pic.snug.moe","mstdn.kurosuke.org","devs.live","toot.dummy.cafe","hyenas.lol","bostonmusic.online","lastfree.space","sauropods.win","equestria.social","shpakovsky.ru","labo.wovs.tk","social.rjp.is","comunidad.nvda.es","gulp.cafe","masto.ashfurrow.com","mastodon.kxn4t.tech","wp-social.net","wao.wtf","fedi.pcwizards.nl","friendica.wasscher.com","social.petko.me","paquita.masto.host","felesitas.cloud","honi.club","clubhouse2.net","social.ctrlz.es","takumi.fun","mastodon.stuffat2106.xyz","mthie.net","magnificentbeardsfan.club","tiksi.net","video.blender.org","marf.space","unbound.social","mi.cbrx.io","zef.social","crypt.n-i.pw","mastodon.honeypot.im","oneway.masto.host","mysportgallery.com","mastodon.olisti.co","yakumo.foundation","lainchan.gay","sdf.land","poly.cybre.city","mastodon.joshlevy.ca","mstdn.wildtree.jp","social.romeov.me","pleroma.wakuwakup.net","okadon.masto.host","gochisou.dev","ple.happytoo.cyou","tty.social","pleroma.jamesp.org","toot.flagrama.net","growers.social","realabc.masto.host","f.voidgaming.co","thechairman.info","mastodont.cat","pleroma.monotremata.xyz","whinge.town","achi.masto.host","keenclocks.studio","pouet.it","social.satan-speaks.com","mastodon.freifunk-minden.de","nitro.horse","toot.40to.ca","akko.disqordia.space","pixellife.app","mstdn.seerr.dev","live.hatnix.net","tribefeed.online","x41.social","mastodon.davidpeach.co.uk","astrodon.social","ihatebeinga.live","tabinezumi.net","canada.masto.host","irrsinn.life","toot.rainbow-100.com","mastod.no","soc.ua-fediland.de","melonmancy.net","social.net.ua","mstdn.swiso.org","flokinet.social","szmer.info","thecitadel.social","mastodon.ftp.rip","dreamers-guild.net","pisskey.io","www.mstddntfdn.online","enby.town","livem.de","p.enes.lv","forfuture.social","ralsei.moe","impending.events","pleroma.dark-alexandr.net","HoFra.rocks","freethinkers.lgbt","mastodon.mim-libre.fr","lia.fail","linfan.moe","fika.grin.hu","pod.vladtepesblog.com","megantoots.com","pleroma.neuromante.net","webs.node9.org","apeiron.aire.ml","bilincakisi.com","mk.absturztau.be","mstdn.quest","lufimianet.jp","mastodon.meis.space","social.tackett.family","frootmig.net","mstdn.kanagu.info","masto.henchmonkey.org","milosz.wtf","toot.coupou.fr","social.boiledscript.com","crazylab.online","soc.punktrash.club","osomatsu.mastportal.info","landofkittens.social","mastodon.humanists.uk","squeet.me","anarchism.space","mstdn.science","gaycatgirl.sex","soc.phreedom.club","hereiszyn.com","idlethumbs.social","purgatos.online","pleroma.haijo.eu","diaspodon.fr","rumbly.net","libre.rikmeijer.nl","social.techn1k.de","pleroma.labrat.space","neue.city","social.tromdienste.de","friendica.mrpetovan.com","social.server17.net","pleroma.8777.ch","jxmsocial.xyz","toot.forth.works","tube.pilgerweg-21.de","masto.sahilister.in","nerdculture.de","p1.a9z.dev","clar.ke","relay.mistli.net","social.teci.world","meowr.me","mastodon.toni.im","misskey.de","pkteerium.xyz","btc.gdn","mastodon.maximejohnson.com","social.gwei.cz","hvddl.com","mastodon.akhepcat.com","pl.cursed.observer","mastodon.melin.org","tchort.institute","romca.tk","opensocial.at","toot.io","lewd.town","social.tourmentine.com","melmc.nohost.me","mastodon.rlp.schule","kiwifarms.cc","pleroma.boingo00.wtf","m.jinwei.me","gnusocial.jp","mastodon.wisellama.rocks","mastodon.zuto.ga","indoverse.nl","mt.nightcore.monster","mastodon.uno","kinkyelephant.com","selfhosted.social","bytetower.social","lgbtqia.space","girlcock.club","webxb.com","social.librem.one","glite.social","mastodon.3fx.ch","acegiak.net","relay.intahnet.co.uk","blog.larand.net","milkey.homes","relay.fedi.agency","scalie.club","mastodon.chrg.nl","pleroma.nthomas20.net","blovice.bahnhof.cz","ps.m0n5t3r.info","andalucia.social","mastodon.sandwich.net","social.defluence.me","social.servus.at","brvt.telent.net","novo-atlantis.null.media","video.hardlimit.com","pleroma.p4g.club","s.lono.space","niscii.xyz","infosec.exchange","aut.social","social.kd0ioe.com","lain.com","horche.demkontinuum.de","noitl.space","nofan.xyz","friends.sophiade.net","boltcutter.network","sanguinem.space","skoops.social","verr.cc","wien.rocks","masto.ninja","cooler.mom","m.stuartgeiger.com","m.adju.st","beta.yuri.ro","jorts.horse","hakorena.hostdon.ne.jp","mastodon.krbn.pl","bitfudge.com","politics.rip","m.tkw.fm","micro.baixllobregat.social","social.jasonsanta.xyz","remolino.town","social.youarewrong.org","social.tranarchy.fish","mofu.kemo.no","wandering.shop","birdbots.leptonics.com","lesbi.in","social.lemee.co","darmstadt.social","zenyasai.g-fukurowl.club","nya.social","social.domov.de","social.hyper.dev","ap.jadiunr.net","friendgroup.social","yiff.life","dcentralisedmedia.com","die-partei.social","mastodon.francoacg.com","mastodon.starshipchangeling.net","social.network.europa.eu","fedi.philament.club","privacy-error.it","mammoth.gry.st","mobilize.berlin","toot.lqdev.tech","thraeryn.net","sudo.cat","kys.moe","my.medic.cafe","uwu.town","welsea.site","jubi.life","social.doma.dev","mstdn.id","a2mi.social","friendica.daniel-siepmann.de","k.posix.gay","social.softmetz.de","ebano.social","ichiji.social","cybersecurity.theater","nukem.biz","shortstackran.ch","rheinneckar.social","social.fedinet.de","dragons.fyi","convenient.email","sms.cybik.moe","muffin.pm","ecosteader.com","pleroma.sloth.ax.lt","jenkins.cc","write.tchncs.de","precure.ml","mastodon.kitchen","waha.work","misskey.bubbletea.dev","gaku-tab-kill.com","dc801.space","toot.thewalkingdeaf.net","social.manalejandro.com","lexingtonbitcoin.social","mastodon.derveni.org","drumbum42.com","qu.oti.st","h.icyphox.sh","social.anartist.org","lopp.social","mk.udongein.reisen","sn.nekojita.moe","mstdn.arks.social","m.noxie.ch","animal-crossing.mastportal.info","uuuu.bigguys.club","macaw.social","coywolf.social","freindal.hallertau.social","daedal.io","social.drivet.xyz","social.rastapuls.com","ibbtown.com","b.koa.im","freshice.org","nahe.social","wndp.cloud","thetooniverse.xyz","tokhmi.xyz","socialize.cyou","creacher.club","pagan.plus","mastodon.aroah.website","friendica-dev.gidikroon.eu","secular-humanism.eu","kudabiverse.com","mastodon.gurubert.de","ukese.me","eureka.chat","alive.bar","mastodon.vlaanderen","mt.shc.kanagawa.jp","friendica.me","social.diskseven.com","poils.pachyderme.net","mastodon.fivest.one","toot.nx-pod.de","fabler.su","uma.milkey.homes","social.dorf-post.de","botok.loveisgrief.tk","pixelfed.nz","social.fbsweb.de","rusoc.xyz","fedisabled.social","friends.cafe","shrike.club","tootsfrom.ahabitual.dev","rando.social","yggdrasil.social","redroo.ml","thesnakepostoffice.online","social.benny.de","mastodon.dvdt.dev","mastodon.qowala.org","feddit.de","masto.asonix.dog","misskey.biribiri.dev","social.kleinrensing.com","social.ppmx.org","ykzts.technology","retrochat.online","don.naru.cafe","winkler.social","social.fedcast.ch","baraag.net","mastodon.ajax.gg","mastodonofmystery.world","mk.chocoflan.net","social.devteams.at","syasai.club","plaid.boxpleats.com","mastodon.bachgau.social","t.windwords.eu.org","retro.pizza","social.jaderune.net","socialserver.science","raspberrypi.social","social.lovingexpressions.net","zzhsuper3.rocks","scipost.social","mastodon.party.at","s.lennysh.com","catgirl.life","pericles.uber.space","pixelfed.fr","pixelfed.automat.click","mastodon.johndevine.co.uk","sparkly.uni.horse","social.stardenver.de","fe.dver.se","biplus.date","social.dexzone.es","pedo.school","lm.korako.me","video-cave-v2.de","piratenpartei.social","mastodon.fam-ribbers.com","socials.xelp.it","shitposting.army","social.smnz.de","mastodon.pass-vault.ru","microblog.wiwie.dk","mellow.zone","snooter.space","mastodon.chir.rs","media.econoalchemist.com","s.ystn.win","nationaljustice.social","society.kalli.st","social.hetnieuweinstituut.nl","swiss.social","social.hunterjozwiak.com","pl.murky.club","melon.land","lol.camp","hub.thechangebook.org","m.servperso.net","succubi.services","proton.deutrino.net","social.blogsofwar.com","bunt.social","mastodon.boiler.social","social.scribblers.club","p.helene.moe","botsin.space","social.xcess.one","mastaudon.org","social.ancow.name","nya.one","nate.im","pixelfed.holdtai.tw","mastodon.bayern","pl.firechicken.net","ai-ml.masto.host","programist.ro","social.goip.de","myfriendsare.gay","alfajet.masto.host","forum.friendi.ca","geeknews.chat","live.w0rmh0le.net","mastodon.postmoderns.info","pixelfed.pandainthecloud.de","mitsukey.cf","mastodon.pdbq.us","k-shiigi-136.masto.host","mastodon.neat.computer","mastodon.kino.ma","social.winter.ink","ne.codes","divas.joburg","debula.ml","a.sc","raygungothic.xyz","mastodon.skye.vg","mast.jakepi.net","pukebucket.pedrocx486.club","vis.social","transgression.cafe","mastodon.michonline.com","ipv6.social","mi.growthers.dev","owlper.ch","mastodon.quantumindigo.org","social.jsts.xyz","superawesomeclub.vip","mk.f72u.net","henshaw.social","metasocial.com","budmo.info","camp.smolnet.org","kadono.moe","misc.brainsoap.net","social.fellr.net","tusk.schoollibraries.net","shigusegubu.club","zombienet.org","pixelfed.au","iamterminally.online","minkiver.se","nyaaa.jeder.pl","peertube.su","maho.app","flm9.me","amii.moe","screenplay.masto.host","noisemakerbot.social","bronyfurry.com","brapbarn.farm","meow.social","otakufarms.com","mastodon.cryne.me","kr.akirin.xyz","social.josephschneider.net","mastodon.hoppinglife.com","socl.bz","maly.io","akko.starshines.xyz","social.targaryen.house","social.owlcode.tech","awoo.chown.me","rustbelt.city","kevinianbryan.social","wienermobile.rentals","mastodon.coffee","mastodon.ladn.org","pooper.social","buta.moe","social.quodverum.com","pixel.autonomous-zone.earth","social.dnitza.com","saysrelax.me","zzzxxx.xyz","mastodon.radtke.pw","warhammer.social","fedi.xirion.net","bookwor.ms","sts.lqt.moe","kagamisskey.com","toot.9wd.eu","pdx.social","welt.all.de","akkoma.agol.one","mastodon.foxocube.xyz","mindly.social","social.zerotier.com","mstdn.nere9.help","beach.city","fuckmu.sk","journa.host","voi.social","soapbox.midwaytrades.com","cloudisland.nz","masto.yapka.org","educator.social","mastodon.au","hock.one","gnubox.org","tekton.network","hingst.org","mastodon.online","social.strausmann.net","videos.cemea.org","eletusk.club","puto.gspot.lol","ondergrond.org","shorage.de","social.ronetcloud.com","mastodon.crazynewworld.net","informaton.blog","eurovision.social","jellis.co.uk","toot.kottman.xyz","indiehackers.social","pleroma.triggeredtux.com","mastodonperu.xyz","pixelfed.gray.cafe","akko.cuddlegirls.cafe","skullvines.xyz","14.umarhadi.dev","ourdiaspora.net","mk.aqr.af","pl.polaris-1.work","social.euzilla.de","tech.lgbt","atergens.com","upload.fedithese.net","ecoli.pink","ani.work","1210mw.com","cheeseburger.social","iyasaretai.pw","live.burningpixel.net","teahouse.social","nekos.one","akkoma.thejar.club","mstdn.myifn.de","psipsistar.com","simulacra.social","m.namt.uk","mastodon.km6g.us","follow.schmaller.de","mastodon.crossfamilyweb.com","shiro.dog","social.tryptophonic.com","oour.org","social.app.ariscard.eu","social.stracknet.com","skj.social","nya.coffee","social.logilab.org","social.zecircle.xyz","ak.cafkafk.com","mi.8mitsu.net","plauderkasten.space","waytoohip.com","artraige.masto.host","social.veltens.org","hub.gerontopilot.de","kurosawa.moe","mao.mastodonhub.com","fedi.katze.sh","sns.ymn.info","universe.noridev.moe","julianjulian.moe","mastadano.com","peertube.linuxrocks.online","social.xthemage.net","wonkodon.com","notes.neocoretext.net","fortressofdoom.me","digineko.net","relay.freespeech.club","toot.lol","esrever.cc","masto.vy-let.software","social.anaproy.nl","tilvids.com","lesbian.solutions","sekretaerbaer.de","stereodon.social","ffxiv-mastodon.com","lrtg.cf","hub.mtf.party","tbo.social","fedi.theepicblock.nl","masochi.st","bosch-haus.home.kg","mastodon.gruezi.net","sup.lelehier.de","videos.danksquad.org","relay.k3tan.com","f.freinetz.ch","hearth.michci.ooo","pix.berdaguermontes.eu","k.lapy.link","rhrish.com","syma.social","lebalkon.de","mastodon.flying-snail.de","448c.net","mastodon.jannis-goeing.de","mastodon.obsidian-group.co","mastadon.littlebonsai.co.uk","social.feathers.link","mstdn.dylanh.dev","puff.place","60228.dev","mastodon.fightforthefuture.org","dhub.social","mastodon.currentlyhq.com","hejfolks.social","socel.net","m.isle.moe","pleroma.electronblueberry.xyz","taeglichkeiten.kopfstim.me","cipioshouse.xyz","m.sanwe.xyz","graphics.social","unstable.icu","social.linux.pizza","video.medienzentrum-harburg.de","mtd.jerstation.com","dasgelobteland.art","mstdn.y-zu.org","pyon.social","mastodon.137i.de","beige.party","luoghicomuni.social","social.tinat.eu","mastodon.0ne.day","social.touhey.org","pixel.johalla.org","pisma.bgzashtita.es","peertube.opencloud.lu","m.terryx.com","veganunity.rocks","detroitriotcity.com","laviadililith.social","prf.me","mastodon.uy","mdn.hinaloe.net","twinkaga.in","bookwyrm.social","misskey.dev","mastodon.trueten.de","social.beachcom.org","toot.teaandkittens.com","friendica.togart.de","www.social.surstroemming.de","butts.team","crypt.lol","mastodon.chrispelli.fun","sperg.city","librosphere.fr","theres.life","fediverse.cyou","hact.org","mastodon.notasquirrel.dev","social.liberta.vip","friendica.keithhacks.cyou","m.wulingate.com","mstdn.ai","mastodon.vishnurajeevan.com","friendica.opensocial.space","friendica.dezucked.com","mastodon.joinhaven.us","social.welford.me","mastodon.snmsoc.org","miruku.cafe","social.scambi.org","mastodon.oeru.org","mastodon.savvy.ch","funkwhale.it","dragons.masto.host","glauca.space","horny.enby.space","toon.social","wpbuilds.social","fedi.pawlicker.com","pics.brocolis.party","pleroma.nl","orctavern.pub","freeframe.masto.host","mk.pupbrained.xyz","cathode.church","mastodon.allnutt.net","mastodon-relay.moew.science","mastodon.bloonface.com","howlr.me","bluenoser.me","lawtalk.social","mastodon.gnomos.org","fedi.mint.lgbt","bydons.ddns.net","news.psylodrumean.fr","so.fnky.nz","mstdn.kizaing.ca","mstdn.mimikun.jp","curmudgeon.cafe","grumpys.online","kokoro.shugetsu.space","mewl.me","social.helpmedog.com","handmade.social","mastodon.express","fedi.togen.xyz","port87.social","betterodds.social","isosceles.love","me.ns.ci","mastodon.sxpert.org","hates.company","m.zzuli.top","mastodon.jehuty11.com","cats.arcades.agency","friendica.produnis.de","gayrobot.club","squad.town","social.chaotikum.org","bergstrasse.social","socks.pinnoto.org","social.mcqn.com","kind.social","bbs.generallyrubbish.net","kith.kitchen","hubzilla.eskimo.com","swj.io","queer.group","s.nicolosus.chat","social.taker.fr","oh.mastocaz.zone","mamot.fr","mastodon.symbolic.software","rouge.eu.org","chatsubo.cbrpnk.dev","mastodon.myacs.com","me.memories.am","toobnix.org","mastodon.energy","prsm.space","amefur.asia","fulda.social","berserker.town","pouet.space","pleroma.chtisurel.net","uncorking.me","mastodon.laurakalbag.com","mastodon.iriseden.eu","s.dc919.org","mastodon.kosebamse.com","dju.social","tw.c-p-b.com","opensourcemusings.com","social.v4v.dev","relay.toot.yukimochi.jp","soc.texto-plano.xyz","alteholz.social","melb.social","mst.universoalterno.es","fedi.sabatino.cloud","pleroma.aaoth.xyz","don2.inux39.me","toot.uoga.net","i.dongxi.ca","1e99.com.br","blueplanet.social","claris.cf","aurochs.moosecow.net","piaf.lamesnie.eu","bologna.one","misskey.silverkey.me","social.surfnet.space","mastodon.edufor.me","friendo.space","lemmy.nekrofilie.ga","fag.lol","foxsay.southfox.me","www.nekotodon.com","mastodon.pinheirodeabrantes.pt","mastonederland.nl","shocktohp.xyz","fox.masto.host","social.mootje.be","spiffy.social","gts.basspistol.org","m6n.onsen.tech","chilemasto.casa","edm.haus","mastodon.hccp.org","kirapower.ichigo-hoshimiya.com","re.lire.im","podcast.c3po.rocks","misskey.zerozaski.tech","plantsand.coffee","zb3.org","nightcord.de","social.evilma.id","albanytrans.gay","ven.uber.space","myfellowverm.in","skrivel.se","loci.onl","pliocene.org","mstdn.amiantos.net","greenplenty.social","t2.thotsofa304.club","social.x220.co.uk","share.elouworld.org","mas.cnova.de","kfem.cat","otp.akkoma.dev","eskate.world","spd.social","cachapa.moe","travelpandas.fr","squ.alid.pw","nocap.fr.to","relay.beckmeyer.us","masto.dotsod.com","kraut.zone","awoo.space","mastodon.eiabea.com","mk.paritybit.ca","seocommunity.social","brockha.us","mi.siotter.xyz","social.3dots.lv","tpo.world","aaa.awoo.fun","mastodon.sbs","mastodon.jcx.se","todon.nl","overheard.social","masto.wayde.tech","toot.jasonscheirer.com","loser.cafe","microblog.social","unfediverse.com","nyaa.locahlo.st","megalodon.tokyo","real-escape.jp","m.sprovoost.nl","2pxnl.de","toot.works","friendica.poppelreuter.de","mastodon.muage.org","hub.hubzilla.de","milker.cafe","social.ncot.uk","voidwood.online","social.9tail.net","talos.link","blue.skye.cx","chaos.social","mond-basis.eu","sweet.succubi.services","rcsocial.net","tvwatch.party","m.biendeo.com","rud.life","mastodon.pro","bad-bit.ch","meow.zarchbox.fr","social.vengeful.eu","cafe.moien.net","mstdn.ryanak.xyz","social.naln1.ca","mstdn.bx23.net","social.opendesktop.org","skastodon.com","social.bau-ha.us","ma.fono.jp","mistli.net","friend.snet.blog","geno.social","sleepy.cafe","toots.dgplug.org","interconnected.systems","tekkadon.manimani.cc","mastodon.hofud.com","edi.social","solarpunk.moe","social.bisby.xyz","mastodon.codingfield.com","mastodon.com.tr","scicomm.xyz","ifrit.gaia.ff14-mstdn.xyz","is.nota.live","fd.inggrismantap.my.id","majestic.monster","social.lxsameer.com","smores.town","hcommons.social","denizens.social","saltlake.social","greenish.red","colorid.es","social.chilira.com","mastodon.zero.lgbt","uuchten.lu","thecroft.masto.host","e0ac-95-141-21-241.ngrok.io","social.thisisjoes.site","kvalhe.im","du.capricom.info","social.vdna.be","f.jymuoyu.com","social.fifteen40.com","soc.catala.digital","trollian.space","miss.nem.one","mastodon.potproject.net","mastodon.prettyrequiem.com","girldick.gay","mk.toast.cafe","elefant.social","muensterland.social","6t.vc","meshed.cloud","social.undrground.org","personaljournal.ca","snack.social","kolektiva.media","retirenow.top","social.joostagterhoek.nl","pixelfed.bachgau.social","udongein.xyz","poslac.com","saltwatercity.org","masto.cyberbunker.tech","thebigeasy.space","osna.social","cover.pm","social-wahn.de","soc.uneex.net","gamemaking.social","social.adamasnemesis.com","pleroma.saturno.black","anticapitalist.party","fluffy.family","mastodon.xolus.net","kanina.be","mastodon.indie.host","social.cybre.town","mstdn.es","qip.wang","social.fym.moe","kaleido.moe","rkor.info","rgb2.com","haunted.computer","mastodon.spydar007.com","badpixels.be","bearologics.social","mastodon.white-void.net","s.thurse.de","social.masked.cloud","notso.cloud","social.emisocks.com","fedi.neon.moe","fedi.nullob.si","deppenkessel.de","f.thesolarrepublic.org","onosend.ai","bsl.compostintraining.club","links.potsda.mn","vrij.social","social.sideno.eu","toot.gru.social","tallulah.fi","edolas.world","rayci.st","outpoa.st","cocaad.de","cancelcultu.re","pleroma.kalterwinter.info","contenttechtodon.org","is.a.qute.dog","kangaroo.to","corteximplant.com","libera.tokyo","firebird.zone","grigson.live","chudbuds.lol","slrpnk.net","machteburch.social","pleroma.crowesnest.io","soc.nhg.moe","the9thcircle.club","social.higherorder.fun","dice.camp","queef4rtrfg6qm6rc3le72lc6p4nhho6a4zuqmviltkcugagwsuhdxyd.onion.pet","balkan.fedive.rs","dresden.network","rage.love","mastodon-nieuwspaal.nl","guineapig.party","medievalist.masto.host","raw.masto.host","khiar.net","social.weho.st","elefant.onetwoxu.de","merveilles.town","elfnostate.info","contrapointsfan.club","community.nicfab.it","eocene.epochal.quest","club.elephantus.moe","social.seattle.wa.us","itabashi.0j0.jp","tenforward.social","social.jlamothe.net","social.nazileaks.eu","elle.systems","skeletons.gay","abyss.fun","podcast.midline.pl","masto.raildecake.fr","carnivore.social","bayfur.club","my-social.nl","lesbean.cloud","books.mxhdr.net","f.kawa-kun.com","scholar.social","mellow.town","toot.roothell.org","laoda.ge","walls.social","obo.sh","mastd.racing","bird.froth.zone","snake.club","analogue.social","l33t.city","veenus.art","ozbustard.social","social.xinghaizhandui.com","libertalia.world","mastodon.yyyyy.world","social.drastical.tech","dog.lgbt","lakomarka.cat","mast.mulliken.net","foresdon.jp","social.anjara.eu","nerd.megahuge.com","pleroma.kitsunemimi.club","zone.liolok.com","canary.fedibird.com","me.oer.me","occult-zuki.com","akko.chir.rs","social.storkeus.xyz","pleroma.ryusei.dev","svariyar.com","misskey.hw2k.com","moarrensis.org","free.burningpixel.net","chungus.cc","cantos.social","seizemeans.com","veeam.ssvane.dk","mastodon.no2nd.earth","u.johnconway.art","pl22.telteltel.com","social.fbxl.net","hubzilla.eu","gruene.social","social.anacreonte.eu","ooops.cloud","misskey.nenohi.net","vnil.de","toot.hoec3.de","glitch.librenet.co.za","mastodon.si","niederbayern.social","sovran.video","mastodon.raptorpond.com","ulman.social","nil.social","plush.city","famline.ru","retrotroet.com","mn.p.starxy.cc","social.securetown.top","mastodon.theguidrys.us","www.librepunk.club","daotalk.cn","relay.c.im","qwerq33.social","t.basspistol.org","oc.todon.fr","miraiverse.xyz","peerverse.space","mastodon.due.ren","mastodon.underworld.fr","twitter.rumiserver.com","gts.batsense.net","federated.glacier.dog","social.alster.space","toot.liw.fi","jibun.club","turingfesten.dk","technodon.social","miniwa.moe","bilibili.org","mastodon.hong.io","cum.salon","mastodon.kneitzel.de","donotsta.re","gnulinux.social","duwa.ng","missgreeney.masto.host","microblog.lunai.re","social.isopod.cool","pasta.ga","godforsaken.website","hub.netzgemeinde.eu","social.afontaine.dev","social.rebellion.global","assortedflotsam.com","hda.zone","mastodon.pirateparty.be","watch.kawen.site","bunny.cafe","mastodon.inferiorlattice.com","mastodong.lol","social.mrjeda.de","pleroma.cyberdelia.com.ar","raccoon.place","gamerr.cyou","social.horrorhub.club","amala.schwartzwelt.xyz","mastodon.peterjanes.ca","react.town","2c.taoetc.org","inaccessible.ac","travel-friends.chat","pwestbro.social","social.tinytip.de","pigleader.com","microhive.net","mouse.photos","social.pjcesteves.pt","fediscience.org","hub.beamweb.de","explosion.party","lou.lt","mastodon.vhome.info","mastodon.chasalin.nl","dsocialize.net","social.openhood.ru","fedi.circuitlocution.com","uberspace.social","mares.cafe","social.caserio.de","team1.rocks","mastodon.kakafe.ga","mastodon.digiwake.net","social.tadzik.net","micro.roblen.at","m.hmn.ist","bv.umbrellix.org","smeap.com","satania.social","msk.seppuku.club","catgram.co","glaceon.social","freespeech.group","mastodon.multimob.be","friendsyu.me","purpleforest.social","kwaa.moe","mastodon.lol","mas.neuroscience.day","quasireal.ca","social.fantorovevo.com","mastodon.liferuler2001.co.uk","gs.yvt.jp","einsicht.mastodontech.de","husk.site","bol.social","pirateradio.social","mammouth.inframed.net","soc.minihost.ovh","pounced-on.me","queef4rtrfg6qm6rc3le72lc6p4nhho6a4zuqmviltkcugagwsuhdxyd.onion.ly","retard.tech","nijimiss.moe","gts.2a03.party","mastodon.insicurezzadigitale.com","fed.elseifnull.xyz","mastodon.pirati.cz","frogmob.life","zhub.link","epsilon-ix.masto.host","social.linksfraktion.de","mastodon.cloud.karagory.com","pixelfed.anzui.dev","glammr.us","the.zymocosm.com","social.evotm.com","pixel.greentrawler.space","relay.chocoflan.net","social.saarland","mstdn.tokyocameraclub.com","federated.press","allison.social","friendica.utzer.de","misskey.goochiegoo.net","nanao.cybtex.fr","mastodon.beer","pasta.wtf","blobfox.es","mastodon.tonywebster.com","ourislandgeorgia.net","hodlr.one","toot.bldrweb.org","ipolska.pl","meemu.org","ericmerlock.social","schottkydio.de","r2.do","updog.no","mastodon.la","social.haj.gf","masto.ai","social.dc6jgk.de","tastybugs.club","toot-lab.reclaim.technology","dynlinux.io","rhabarberbarbara.bar","hub.bayliss.social","planet.chrisbeckstrom.com","schelling.pt","social.aliceice.de","mstdn.nielniel.net","idf.social","mastodon.jordanwages.com","fr.zy.lc","dica.interfel.de","mastodon.saarland","magickal.club","pleroma.gaos.org","mastodon.riedl.net","calobar.club","metalhead.club","mastodon.tetaneutral.net","mastodon.cross.net.uk","masto.pt","yandere.cc","chiurbanist.com","friendica.mnementh.co.uk","the.voiceover.bar","social.bobcall.me","hexadon.net","mastodon.geekspawn.xyz","mastodon.haram.kim","masto.ezhevita.dev","fotofed.nl","masto.technology","mstdn.fr","tube.network.europa.eu","zirk.us","fandom.garden","buttplug.zone","social.bund.de","social.vlen.org","pleroma.marud.fr","ridgebacks.social","io.pace.rip","peepeepoopoo.gangstalking.services","borahae.love","social.gould.cx","social.gabekangas.com","neko.ci","social.poltava.dcomm.net.ua","loa.masto.host","fed.thecyberdeck.xyz","perktold.xyz","pl.fanyx.xyz","sciencemastodon.com","mastodon.roflcopter.fr","social.offsign.nl","dflatmajor.social","xelland.social","mastodon.tianshengli.me","troll.cafe","giersig.net","mastodonnederland.online","don.mamemo.online","avantwhatever.org","social.xenofem.me","misskey.social","akko.anemoneya.me","cyberfurz.social","abdl.link","social.urspringer.de","slon.yojik.net","birb.space","greatjustice.net","neongrove.social","toot.sg","aragon.sh","a11y.info","lemmy.ml","alcatir.com","social.trom.tf","sushi.ski","ukadon.shillest.net","subversive.zone","mk.autonomy.earth","fed.sonnenmulde.at","social.coop","clubcyberia.co","social.teamx.cc","pixelfed.se","mast.yurec.online","dryad.gay","mstdn.tamag.org","tweep.club","mastodon.iow.social","404.inexist.club","charlestown.social","honq.me","typo.science","friendica.art3mis.de","el5.net","epichairekakia.com","m.fa.gl","gentoo.live","meinungsschubla.de","pleroma.cybervalley.org","toots.cc","transmom.love","social.tulsa.ok.us","don.fetus.jp","mastodon-belgium.be","nye.lol","fed.celp.de","anar.chi.st","misskey.levome-dol.com","rail.chat","mastodon.dfsek.com","techthoughts.io","jollyville.net","hackers.town","waifuism.life","plushies.social","weird.tw","mk.lei202.com","mastodon.hk","introvert.social","aana.site","social.levelxstudios.org","fedi.anti-degeneracy.club","misskey.ipv6-only.site","pleroma.nem.one","mastodon.pundo.com","toot.tantalum.life","occult.institute","dontdontdontletsstartthisistheworstpartcouldntbelieveforallthe.world","kolektiva.social","masto.galooph.com","mk.cybre.ninja","bahn.social","friend.pierobosio.info","greenfield.masto.host","fedi.gemlog.ca","comic.social","med-mastodon.com","mastodon.r-flash.eu","bookrastinating.com","modestymaise.com","mastodon.flyingmou.se","knoxodon.com","staging.mstdn.misaca.network","social.shanghaifantasy.com","social.gitea.io","mirr0r.city","eientei.org","tablegame.mstdn.cloud","federation.stream","cute.science","fediverse-lite.com","caonima.wtf","hespere.de","hellsite.site","gamelinks007.net","nonbiridon.hostdon.ne.jp","tree.pigeons.cloud","13bells.com","fuwa.pink","carl.fish","www.fag.lol","trans.fm","communitycenter.glitchcityart.club","avatastic.uk","wxw.cat","emeraldsocial.org","rollenspiel.social","pleroma.doserver.duckdns.org","gts.u8.is","marsey.club","ieji.de","gaku-tab-love.com","comm.social","www.directory.trade-free.org","fandom.ink","mastodon.halibut.com","pleroma.agol.one","www.loganjohndarylgraham.xyz","radiosocial.de","magincia.cafe","social.wings.dev","social.mecanis.me","friendica.ownbox.be","social.eutychia.org","social.masto.host","skeptics.social","mstdn.nerd-culture.tech","social.azkware.net","verified.mastodonmedia.xyz","lgbt.io","social.macwinlin.cloud","mastodon.hamburg","community.cockworshipper.com","mstdn.nanamachi.net","liker.social","nya.lemonade.moe","xxx.azyobuzi.net","social.nah.re","youthweb.social","andersen.social","m.fal.moe","mastodon.ar.al","dissident.business","machikadon.online","standup-comics.net","xn--dgtt6ucql1igfpb.org","social.lehtiin.eu","pleroma.asn.mobi","hoob.io","pleroma.gidikroon.eu","mexico-pensante.blog","randland.party","social.hergorn.com","social.tofu.pt","mastodon.aventer.biz","mstdn.ch","pixelfed.teahouse.social","mastodon.meowcat285.com","yip.yip.yip.yip.yip.computer","akkoma.eniehack.net","saturation.social","plustodon.net","node1.mastodong.net","werd.social","mstdn.cygnan.com","pleroma.wafflec.one","unipar.online","primordial-library.gq","cave.mancave.de","social.dsmouse.net","habbnn.com","hey.hagelb.org","federated.media","cryptodon.lol","socia.dev","mastodon.morgiano.it","s.kevin.cl","social.mx00s.com","hitchhiker.social","andyd.uk","bolha.us","friends.ravergram.club","peertube.chatinbit.com","social.hendrixgames.com","social.hax.technology","truthsocial.co.in","friendica.mbbit.de","kachel.social","mastodon.dalaomai.cn","toot.ahnlak.com","social.anthro.cc","pandas.social","bear.community","ontological.city","fediverse.thefloatinglab.world","blackspace.social","fedi.underscore.world","fedi.at","m-i.im","social.espeweb.net","techhub.social","social.krylc.cloud","social.ziez.eu","sneed.404.mn","cofe.rocks","fedi.seriousbusiness.international","bae.st","dosgame.club","mastodon.jemverse.xyz","mastodon.cgx.me","leftist.network","datflow.tech","pinkorange.red","social.anoxinon.de","hachyderm.io","social.cthompson.com","mstdn.unasuke.com","bitbang.social","toot.gg","microblog.pub","oransns.com","rivals.space","freeatlantis.com","friendica.hashy-net.de","slashine.onl","post.hcj.sh","desarrollo.lugoweb.es","mastodon.chatinbit.com","freechat.ro","mastodon.cloud","mk.outerheaven.club","wall.demouliere.eu","easy.saramara.ai","social.nicolas-constant.com","balbec.xyz","ailbhean.co-shaoghal.net","toot.martyn.berlin","iamalive.digital","ploovi.us","social.gronkiewicz.dev","vibrant.li","social.chiefgyk3d.com","mastodon.salecroix.fr","arguos.com","bloor.tw","social.diva.exchange","n00b.fr","twtr.plus","test3.syuilo.dev","booktoot.club","piipitin.fi","writing.exchange","misskey.zwoelfdreifuenfundvierzig.net","entomophagy.world","md.jl-systems.se","k.iim.gay","pleroma.1d4.us","438punk.house","honk.helby.me","social.nomagic.uk","nyan.network","quietplace.xyz","asimon.org","mastodon.end.io","mastodon.digitalsuccess.dev","pirati.ca","dline.xyz","bigshoulders.city","banana.dog","lile.cl","social.alternativebit.fr","ak.kawen.space","social.jokiller230.tk","from-arctic.net","oerfoundation.org","fissionator.com","we.1being.org","hispabot.myvnc.com","kicou.info","neet.church","simkey.net","kawaii.kitsune.cafe","silversword.online","mk.kaifa.ch","video.manicphase.me","treehouse.technopagans.de","lt3.co.za","vibewave.space","commiespace.duckdns.org","weeaboo.space","mastodon.duncanhart.com","uraniumhexafluori.de","mastodon.stefofficiel.me","icosahedron.website","bangdream.space","mstdn.co.uk","mieke.club","mast.eu.org","shitpost.racing","h55.social","test.error.im","mementomori.social","lethargic.talkative.fish","masto.louzao.network","social.pondr.nl","relay.dresden.network","pythonist.as","freiburg.social","eldritch.cafe","en.osm.town","tried-to-do.science","m.divita.eu","rageparty.club","emacsen.net","frontrange.co","firefaithfellowship.com","masto.nobigtech.es","mastodon.bitcoin.ninja","s.chorok.cafe","flumph.masto.host","eegle.cloud","podcastindex.social","mastodon.matrix.org","empty.cafe","pztrn.online","rpi.limited.systems","pleroma.fun","mstdn.dk","fedi.tyil.nl","mochiwasadon.com","dis-le.de","catala.digital","arugula.social","bkgrdclrschm.link","hub.sakuragawa.moe","tardar.social","social.photogabble.co.uk","imd.social","town.planetai.re","itsover.cyou","mastodon.utwente.nl","mastodon.lermer.nl","decept.org","social.sd.ai","friends.mbober.de","friendica.ingram-braun.net","allpro.social","shitpost.poridge.club","mastogram.com","the.shitposting.network","mastodon.eus","null.town","miyon.miyon.org","mastodon.insert.tk","mountaintown.video","pfiffer.org","katariya.us","social.bckr.me","gorgon.city","awoo.fai.st","trekkies.social","mastodon.russ.network","yams.lol","types.pl","troeterei.de","stormlight.space","mis.weetao.myds.me","mar.archipielago.uno","useless.merveill.es","misskey.7ka.org","afternoon.chat","ms.technodro.me","pl.kitsunemimi.club","ubuntu.social","video.mezzo.moe","nondeterministic.computer","tomo.airen-no-jikken.icu","mastodon.petertodd.org","toot.whatever.cz","sobieski.social","m.dogcraft.top","front-end.social","newsie.social","microblog.at","mast.moe","mastodon.afromunkee.live","fed.im","pub.patricia.no","fairground.moe","qua.name","loves.reisen","gts.fedi.tech","don.nzws.me","mastodon.kaskadee.eu","beta.birdsite.live","sns.tsubasaori.be","cuties.social","social.bethejustin.com","ninjaturtle.xyz","javisst.space","social.emily.news","idontwant.social","darnell.app","computerfairi.es","bladerunner.social","mastodon.earth","malu.today","misskey.pnyhf.eu","social.screamingatmyscreen.com","videos.pair2jeux.tube","puz.fun","mastodon.floss-marketing-school.com","social.jesse-saenz.com","social.codeplumbers.eu","harahar.com","pixelfed.cats-home.net","fediverse.bbad.com","weibo.run","social.platypush.tech","mastodon.yantou.co","m.deeloves.me","mstdn.maud.io","mastodon.fosslife.org","popon.pptdn.jp","m.smto.pw","mastodon.sideslip.social","bulbulator.net","medic.cafe","social.tenak.net","haskovec.social","social.xmflsct.com","chat.brainbaking.com","layer13.p7.co.nz","art1sec.uber.space","ist.social","bytesize.social","social.florianjensen.com","awscommunity.social","fedi.dananglin.me.uk","drizzle-damp.net","toot-bionaut.de","akko.unix.dog","pl.pube.tk","thevipvipers.space","mstdn.ijs01140.com","mastodon.tiennot.net","lor.sh","stereophonic.space","mastodon.dustinwilson.com","slime.global","lipn.info","mastodon.partipirate.org","mastodon.nyanshell.com","social.mezzo.moe","social.reconnectcolorado.com","social.helvetica.fm","taiyaki.online","provo.lol","morale.ch","social.filik.eu","borg.social","mstdn.tomokiwakimoto.com","social.makerforums.info","natter.wtf","mastodon.art","schmaker.eu","diode.zone","xn--69a.xn--99axc.xn--y9a3aq","otaku.whomartthou.com","sueden.social","ligma.pro","social.unraidcloud.de","whitelion.me","pl.secretsealing.club","irrelephant.co","honk.meme.technology","philos.fkn-systems.de","rebelsocial.media","mstdn.progressiv.dev","hedgehog.pub","friendica.ambag.es","bpd.monster","federate.hopto.org","ephemeral.glitch.social","mstdn.crux.noho.st","social.afront.org","freundica.de","social.wasscher.com","jam.family","mastodon.grimerica.ca","social.gorritodeplata.xyz","social.coletivos.org","social.juanlu.space","soc.umrath.net","tiphon.nerv-project.eu","mastodon.ktachibana.party","friendi.linuxand.beer","xhais.love","blahaj.social","masto.brightfur.net","mstdn.syui.cf","antenesse.ml","soc.luciferi.st","wang.nz","social.5jung.com","gly.one","social.labmonkeys.space","mastodon.vierkantor.com","spook.social","mstdn.homes","mastodon.mariustimmer.de","social.nitrokey.com","schaumburg.social","pleroma.freespeech.club","sironi.tk","pixelfed.fi","williamsonday.buzz","coconatsu.co","jase.social","explore.beer","nagoyadon.jp","beepboop.one","neurodifferent.me","mastodon.aargaunet.ch","verkehrswende.social","toot.krivokuca.dev","habitat.zelle.one","cho.yukiya.me","mastodon.aspisdata.com","toot.kingj.net","mastodon.exitmusic.world","mastodon.tobedefined.net","pleroma.jezra.net","mas.ggr.me","pixel.tchncs.de","straylight.expectnomore.net","makimaki.jp","social.growyourown.services","toot.berlin","kysocial.org","toot.nottechnicallyalien.com","social.hanashi.dev","ctdl.co","mstdn.shalyu.run","comidade.casa","social.nekover.se","xxivproduction.video","ryona.agency","friends.deko.cloud","social.szkod.ovh","birb.site","mastodon.ericbeckers.nl","cdrom.tokyo","toot.gnous.eu","braydmedia.de","pixel-fed.co.uk","hoblin.ngrok.io","social.touha.me","toet.dnzm.nl","outerheaven.club","raptol.net","fedi.dotsod.com","hub.art3mis.de","d.c-cha.cc","affixed.art","tailswish.industries","hal9.ooo","fem.social","social.rebtoor.com","plaza.medium.place","mk2.mstdn.life","schach.social","m6n.io","mixin.love","very.tastytea.de","shitcoin.land","thelandofooops.icu","cmdr.social","mstdn.pedrocx486.club","pixelfed.sdf.org","akkoma.ilja.space","pleroma.potatoxel.org","social.kyiv.dcomm.net.ua","livellosegreto.it","gaymer.social","twit.dispersio.us","nubi.social","sigint.life","fedi.absturztau.be","itmslaves.com","burn.capital","hax0rbana.social","fediland.nl","xn--s8w913fdga.chn.moe","duck.haus","moobarb.club","misskey.sda1.net","rason.twilightparadox.com","mastodon.pub.solar","poto.cafe","mememagic.net","nojack.easydns.ca","ielts.boats","social.tigerstyping.com","mastodon.me.uk","mk.godspeed.moe","stellar.build","pr0mised.life","qdon.space","dan.mastohon.com","social.tar.black","pleroma.lokean.org","dog.estate","social.enovale.com","mastodonsweden.se","breezy.wildsurf.net","pixel.art3mis.de","society.ishygddt.xyz","musain.cafe","umbrella.cafe","libranet.de","mastodon.rdh27785.net","ppplot.top","gultsch.social","0w0.is","social.gamesartliveperformance.com","boing.world","social.node001.net","toot.me.uk","estradi-niol-of.services","borken.social","terra.incognita.net","fractalego.social","messydesk.social","mastodon.nesven.eu","flynn.me.uk","social.lelehier.de","pewtix.com","novaloop.social","twingyeo.kr","social.malacology.net","ferrus.net","social.fluffel.io","libertynode.net","yysk.icu","neighborli.xyz","epistolary.org","social.balsillie.net","linuxjobs.social","akm.longyap.name.my","slothy.win","cobaltkiss.blue","dobbs.town","masto.ingeechat.party","worm.horse","horizin.de","samenet.social","don.m2hq.net","messurrection.com","delab.re","bikeshed.party","river.group.lt","pixelfed.cheeseburger.social","pleroma.mnko.info","mastodon.libutzki.de","notnull.click","social.gl-como.it","odezie.eu","leafposter.club","socialcry.de","mk.wolfie.pw","sosyal.cezeri.tech","maron.blue","social.dog-s.global","techforgood.social","noodle.social","mstdn.io","mastodon.starrevolution.org","fedi.cc","mstdn.cf","meisskey.one","fromm.social","jitakurack.chotto.moe","c.im","msnis.radiate038.com","socialfed.nl","mk.starnix.network","mst.vsta.org","social.treehouse.systems","snapp.social","hrmtc.io","pleroma.ecliptik.com","social.sp-codes.de","pl.kotobank.ch","merovingian.club","fedi.lowpassfilter.link","mastodon.madrid","fedi.criminallycute.fi","indieweb.social","xn--xxa.computer","racem.us","mast.dragon-fly.club","social.badabam.net","www.urbanmind.net","hsnl.social","social.metaccount.de","mastodon.cc","glitterkitten.co.uk","ck.treasuredgem.xyz","mastodon.sngsk.info","khp.ignorelist.com","md.kakise.tech","pl.info.natehiggers.online","creative.ai","blobfox.coffee","probablyfreespeech.com","squawk.avian.space","astronomy.social","trans.enby.town","cybre.club","pone.social","blah.rako.space","pleroma.karjalazet.se","sackheads.social","orbsafe.masto.host","crucible.world","ym.rookieo.com","anonsys.net","shadowsocial.org","crimew.gay","piggo.space","social.oriol.ie","tacocat.space","misskey.cloud","aesops-pawn.shop","justicewarrior.social","libori.social","mastodon.fjerland.no","social.fouquet.me","feed.victor.earth","kish.social","mastodon.bits-und-baeume.org","social.inter-mundos.de","mastodon.sludgepool.org","tanztee.social","mattyaski.mattyatea.me","nalocal519.social","social.4f9e1738.ignorelist.com","mastodon.f4n.de","mofmof.coffee","social.joelle.us","social.nettek.at","spearman.xyz","sopuli.xyz","fedimon.uk","mk.kirota.net","yunyun.moe","social.main-angler.de","toot.kartonrad.de","bavaria.social","elb.cloud","bangdream.tokyo","mastodon.tardis.pw","necropolis.online","ghost.cafe","cailincat.cloud","trpg.cloud","friendica.chilemasto.casa","hund.schule","hannover.social","sneed.shop","write.as","submarin.online","froth.zone","london.fetish.church","nerddao.xyz","polyamory.social","mastodon.r3pek.org","mastodon.sniff122.tech","loutre.info","frankenwolke.com","descentraliza.me","zoinks.one","campfire.farwalker.ca","social.kevinisageek.org","cb.janusworx.com","furry.engineer","fedi.caffeineandfox.es","sgp.hostdon.ne.jp","b612.me","masto.gundan.es","im-in.space","fediverse.tv","lgbtfree.zone","toothole.org","ps.s10y.eu","chat-node.uk","unmensch.xyz","mastodon.ctseuro.com","blop.social","miss.mouse.services","cnova.de","mstdn.sublimer.me","p.oshiteku.app","bananachips.club","social.jazzbutcher.com","ufm.lol","roidesbulgares.rocks","social.tnhh.org","social.ksite.de","akkoma.mastodont.cat","social.northernvoice.app","mk.catgirlsfor.science","social.mochi.academy","loma.ml","akkoma.catgirlin.space","cybt.de","tube.tchncs.de","fax.social","friendica.exon.name","my-spaces.social","misskey.omhnc.net","akko.saturno.black","social.icke.me","ruinous.social","bgme.me","onlinegemein.de","f.iroiro.party","sunny.garden","serotonin.party","pawb.fun","bittube.video","queer.hacktivis.me","cthulhu.love","mastodon.otherreality.net","social.timespiral.co.jp","devprod.social","mastodon.danov.biz","hashi.icu","msk.minetaro12.com","pl.valkyrie.world","noam.horse","a.metube.ch","mastodon.unsuspicious.website","social.doghub.eu","togart.de","waldvogel.family","linernotes.club","mastodon.ie","woem.space","smokecircle.co","hostsharing.coop","nayukana.info","kirishima.cloud","m.ocsf.in","sotl.social","sc.sigmaris.info","pleroma.robertoszek.xyz","mastodon.elevenways.be","monogram.org","vocalounge.cafe","social.beepboop.ga","luna.vg","social.tumelum.de","pleroma.lord.re","social.nofftopia.com","pleroma.shunderdo.me","mastodon.infra.de","webhookfrom.space","social.ordinal.garden","social.buckket.org","pix.metaversum.wtf","ofuton.io","ip.omorashi.cc","initiate.space","sansschatten.com","mstdn-nicholl.uk","aaronparecki.com","mxtthxw.art","stellaria.network","social.penguinability.net","triangletoot.party","mastodon.blake-hofer.net","rettiwtkcuf.social","tube.kockatoo.org","jonleibowitz.social","pol.social","misskey.xianon.net","mastodon.xsoftware.it","sn.angry.im","social.politicaconciencia.org","mstdn.jnsk.info","f.3ischn.de","mastodon.linuxbox.ninja","mk.asie.pl","fediverse.wesnoth.org","mastodon.izzz.fr","fosstodon.org","friendica.hubup.pro","masto.ukrainedao.love","moa.st","social.sakamoto.gq","slippy.xyz","mastodon.fibee.fr","misskey.traction.jp","social.apreslanu.it","qaf.men","not.acu.lt","glitch.social","social.crabs.life","pubgate.autogestion.org","x0f.org","groups.qoto.org","kitsunet.net","md.ilyamikcoder.com","pixlfeed.theplanet.rocks","btc21m.net","queer.party","mastodon.ibax.org","climatejustice.global","vael.town","blog.jackspangler.xyz","zug.network","pcgamer.social","su.siberia.work","relay.homunyan.com","springbo.cc","chin-co-ne.co","fedi.xaloc.space","social.tarasis.net","toots.cordelya.net","ilja.space","mst.templar.one","stogramm.xyz","my.elven.pw","mastodon.gal","douchi.space","ricearoni.org","hollablog.at","glitch.gray.cafe","misskey.assaultli.ly","snug.moe","fediverse.keithzg.ca","social.cosnomi.com","tarasupadon.com","sea.social","social.kiesow.net","friendica.eskimo.com","mastodon.eole.education","social.chvp.be","lediver.se","river.divineduty.xyz","fedi.fullstuck.net","pixey.org","lost-in-outer.space","social.beckmeyer.us","typo.social","badly.co","social.lansky.name","zomglol.wtf","veronaxxx.masto.host","social.polonkai.eu","social.ancreport.com","recsys.social","toot.icu","econtwitter.net","tennis.masto.host","sllimnod.com","pachyder.me","friendica-test.rompe.org","social.theplanet.rocks","post.ebin.club","mycrowd.ca","erisly.social","mstdn.moe","social.veraciousnetwork.com","quietcar.social","nicolas.steinmetz.fr","social.realnephestate.xyz","mast.linuxgamecast.com","lol.dydx.moe","appdot.net","xn--69aa8bzb.xn--y9a3aq","social.margiovanni.com","evil.social","social.alesan.io","spheres.solarnight.net","futurenow.agnessa.pp.ru","cyrix.matto.nl","social.iseks.de","suedi.club","pixelfed.zwoelfdreifuenfundvierzig.net","tea.iam.slg.br","fedi.aeracode.org","social.goodanser.com","dingdash.com","grandma.space","fed.xnor.in","darkkeep.net","pipou.academy","mastodon.satoshishop.de","mstdn.bmw-and-more.info","pleroma.remerge.net","social.secret-wg.org","m.tzyl.nl","cum.camp","mastodon.sergal.org","communicating.cypherpunk.observer","social.brokenbydesign.org","social.boritsch.de","gabvp.masto.host","social.xbm.se","begovoy.social","md.korako.me","taullo.social","taruntarun.net","akademienl.social","appalachian.town","mastodon1.artsrn.ualberta.ca","jaye.sh","social.a4o.de","social.antifa.gmbh","masto.mtcrew.org","fedibird.com","eattherich.club","campaign.openworlds.info","ap.maladaptive.art","echo.yeahnet.dev","acc4e.com","pl.jugregator.org","mb.jenot.info","dirtyhobby.xyz","pleroma.cucked.me","ap.gjcloak.top","dprj.xyz","peertube.fr","witches.pub","w3c.social","don.nekocross.xyz","so.prx.link","social.secretsealing.club","phantasma.cloud","z0ne.social","mastodon.bida.im","kcmo.social","moosetodon.com","g1zm0.social","mastodon.frkn.co","mofu.one","nth.io","social.psjb.me","cityofchicago.live","9kb.me","heislandmine.work","sludgepool.org","social.cativa.net","toot.svenbrier.eu","toot.losk.me","mastodon.fulltermprivacy.com","framatube.org","social.wien.rocks","fwedivewse.vfpmedia.com","pony.gallery","xarxa.cloud","haha.rocks","castlecannon.house","hub.natehiggers.online","social.la10cy.net","social.skrep.in","m.quaoar.xyz","honk.petersanchez.com","mastodon.halt.cl","soziale.verwirrung.institute","social.claes.se","honk.vedetta.com","pleroma.amefur.asia","wildwood.town","soc.redeyes.site","jamesgallagher.social","social.pixels.pizza","kabuki.club","petrous.vislae.town","meow.lgbt","sciences.social","toot.portes-imaginaire.org","social.vasilis.nl","law.builders","social.mrhands.horse","a-chill.space","v3.cathoderay.tube","itdev.social","pangu.hengsha.host","byteshift.io","mammothcirc.us","masthead.social","mahalle.li","mastodon.nicfab.it","mk.yopo.work","mastodon.dev-null.rocks","toot.jeena.net","seafoam.space","s.echapp.com","prismst.one","eeeeeeeee.eu","m.markjones.cloud","liberalism.masto.host","fyrfli.live","socialdistancing.dev","mastodon.paftech.se","toppickz.com","mstdn.skullb0x.io","qbvhb4nv.uber.space","social.sndm.me","mimmoth.club","absolutely-zero.monster","social.gamez.name","social.nanosector.nl","mstd.dansmonorage.blue","pl.kpherox.dev","toot.monny.cloud","social.netdc.ca","social.michaelbrooks.co.uk","social.skewed.de","transient.garden","mstdn.yaesu-eas.tokyo","m.bonzoesc.net","bayes.club","fedi.fancycade.xyz","vmst.io","fedi.ratemycancer.com","social.kernel.org","litterae.social","mstdn.fuyumori.net","pleroma.g307m.com","hispagatos.space","bsd.network","mstdn.im","flimpie.net","terrible.place","toots.martyn.berlin","minohdon.jp","functional.cafe","hexa.ninja","drosophila.social","bnkr.cc","hom.ph","shrine.moe","mstdn.yamaken.jp","social.undisruptable.technology","mastodon.gougere.fr","revachol.city","mas.xorbit.me","catdon.life","toot.gagniard.org","hci.social","puddle.town","mastodon.communick.com","m.ix.is","kompost.cz","sci.kiwi","soc.citizen4.eu","stackpointer.ws","mstdn.bougiekitty.net","barcelona.social","wireless.cat6.network","bantu.social","albaruthenica.masto.host","anti-social.online","meow.cloud","frankly.social","lemmy.rollenspiel.monster","thejoyo.com","prolinos.social","mast.mako.li","poplava.net","extradienst.net","friendica.ru","scl.zmb.cm","mastodon.obspm.fr","pleroma.stream","social.zdx.fr","intahnet.co.uk","coales.co","twit.social","mastodon.humanistische-union.de","hermit.cafe","tv.schenklradio.de","circus.town","gts.68kmentat.com","mastodon.alphapi.me","mastodon.timnolte.com","social.shorkpit.xyz","social.producer-network.de","hypercube.masto.host","social.nico-bayati.de","m.eula.dev","my.brick.camp","inkwell.space","pleroma.guizzyordi.info","hightops.ink","f.praschnig.com","muknown.jp","social.edu.ci","mastodon.mobi.com","soc.mahodou.moe","frnd.nanoscopic.de","toot.lgbt","sonomu.club","pettingzoo.co","epic.meme.moe","fed.alteregocreations.com","grid.p7.de","live.bungle.chat","social.rebased.network","decentralised.social","d-fens.systems","tsunde.ru","blue-mastodon.club","norden.social","zztails.gay","kongwoo.icu","keybored.me","social.ataxya.net","mstdn.media","fuckgov.org","social.davidgarywood.com","toot.spooky.computer","neenster.org","yuki.ink","social.grimneko.de","mastodon.wenzit.de","peertube.vapronva.pw","electricrequiem.com","rxtx.nl","info.prou.be","sheep.network","yamagadon.com","mastodon.raffi.de","pixelfed.bunix.de","mastodon.mariusdavid.fr","spank.ws","reglaprimordial.com","en.relay.friendi.ca","mastodo.fi","raitisoja.cloud","mastodon.business","video.dresden.network","abandoned.opprimonational.com","pleroma.ctu.cx","robot.rodeo","mstdn.zoddo.fr","gts1.zatnosk.dk","a.nti.social","mastodon.lertsenem.com","bakunet.me","m.filmfreedom.net","altelectron.org.uk","stevenbrady.com","mastodon.canonicity.org","mastodon.robinsmediateam.dev","social.marud.fr","kancolle.social","fediweij.nl","mastodon.rzgierskopp.de","thehb.me","mstdn.satania.social","honkwerx.tech","mathtod.online","bitcoinlizard.net","hubzilla.fediversum.de","widerweb.org","pm.ernix.jp","mastodon.cabaal.net","miaow.gay","roleplayers.bub.org","kahtlane.place","digipres.club","mstdn.superspeed-fall.com","anime.website","mk.igwigg.space","0lb.be","fair-verhandeln.de","toot.thoughtworks.com","animesexual.community","netzsphaere.xyz","nancy.social","trapped.online","eicker.news","m.beiting.org","mastodon.xyz","pleroma.popolon.org","isesh.com","social.plaxon.de","plem.sapphic.site","youdabomb.social","social.sturtz.io","nova.community","wenzlik.social","gamedev.lgbt","social.moirai.cc","legal.social","social.spamourai.fr","social.weisensee.me","pars.ee","dogbottom.com","telescope.garden","redwombat.social","nickslaney.net","nobl.ink","toki.social","mastodon.acerbo.me","libertarians.social","social.dropbear.xyz","matingpress.quest","tha.closed.social","hub.tschlotfeldt.de","www.banepo.st","stella.ocellaris.dev","sculpin.social","www.tromjaro.com","peertube.touhoppai.moe","bbs.kawa-kun.com","mstdn.alicia.ne.jp","toot.jokiller230.tk","live.retrostrange.com","jlelse.blog","raggedfeathers.com","varis.tv","mastodon.ml","chillout.chat","pleroma.viridianpatriots.com","mstdn.bronyfurry.com","social.lavanderblue.art","social.synergetic-design.com","tzcafe.com","fangl.in","curious.simio.us","climatejustice.social","mo-na.space","taciturn.social","a.gup.pe","mastodon.qkjr.xyz","animal.business","mastodon.in.th","lem.social","mastodon.internet-czas-dzialac.pl","freewheel.social","mastodon.williamsonday.info","mstdn.osaka","owncast.cryptoschizo.club","mastodon.shelldog.de","mastodon.wihel.de","ifwo.eu","mastodon.icu","bussy.monster","imaginair.es","friendica.xyz","social.mjd.id.au","antabaka.me","inosoft.social","tkz.one","mastodon.nz","flower.afn.social","chriskthomas.com","hell.social","peertube.european-pirates.eu","social.lond.com.br","mimimi01.masto.host","mas.glowing.surf","mastodon.socdojo.com","mastodon.parleur.net","social.noraa.gay","mastodon.brad.ee","friendica.oldkid.digital","mnufc.masto.host","misskey.chn.moe","ecoevo.social","pub.waffle.tech","iwatedon.net","social.roger.family","noblogo.org","beehaw.org","v2.flyingcube.tech","social.sergeant.net","nixeneko.info","social.fkeinsten.de","social.qaq.wiki","pegasus-kunst.social","ue.oiaa.aaio.eu","queer.af","hulvr.com","pleroma.tulln.social","social.polymerwitch.com","swingset.social","mstdn.mx","fbi.pm","brignell.co","brickbat.dev","QuarteredCircle.net","mastodon.popps.org","sivar.cafe","writeout.ink","squanch.xyz","social.anon-groups.de","social.liip.ch","social.msitc.de","social.k3tan.com","social.handholding.io","mastodon.darkplanetego.de","suomi.social","pleroma.atsuchan.page","kafeneio.social","mk.yunyun.moe","canerduh.ca","misskey.boon.chat","xiii.ch","lustigetiernamenbubble.de","fedi.jiyu.dev","h.kher.nl","mastodon.antisocial.science","social.rootaccess.org","social.uhoreg.ca","talk.mls20.de","pleroma.chaoswit.ch","big.trash.haus","wue.social","misskey.wimmer-edv.de","det.social","mastodon.com.br","seaofog.com","aus.social","tragi.cc","magicalgirl.party","friendica.org","vt.social","hackerjunkie.nl","uelfte.club","doux.fun","tea.fedicafe.com","social.45bis.cc","test.breadqueues.com","social.exozy.me","u2.social","mstdn.nrkn.fr","micro.guedes.com.pt","m.nintendojo.fr","gamingjp.org","pleroma.io","p.mr64.net","blog.fedi.tech","m.einverne.info","xn--rtta-qoa.nu","queer.garden","aachen.social","forked.io","mastodon.byte23.net","preciouslittle.life","social.wolfe.casa","pleroma.leftychan.net","md.xps2.net","barritar.uc-netcorsoft.de","relay.mastodon.kr","barcamp.social","mrelay.link","troet.cafe","rebased.io","s.notk.ai","asocial.grimstack.xyz","misskey.nauzome.com","yellowmustard.club","norrebro.space","fedi.aroace.space","toot.kif.rocks","mastodon.fraize.com","mastodon.bofhers.es","cassone.social","mastodon.org.uk","oliphant.social","social.kabi.tk","h4.io","defenders.town","social.binarydad.com","mastodon.land","share.tube","social.avery.cafe","thefire.work","newskey.cc","birds.garden","xmrposter.club","tines.spork.org","friends.johalla.org","mastodon.flopnet.eu","fedi.cheeseland.xyz","toot.mantyke.icu","mastodon.libresilicon.com","cliq.social","social.scot","antizuckbook.com","mas.to","dumbopinions.xyz","ork.institute","mk.mozc-plasma.tech","social.lolcalhost.de","etiketi.de","ng.cathoderay.tube","social.garwood.io","toot.thedoodleproject.net","waste.social","mstdn.starnix.network","bigchungus.theautisticinvestors.quest","silkhe.art","xeno.glyphpress.com","soykaf.org","mastodon.jalgi.eus","social.imirhil.fr","eboks.social","goblin.camp","mstdn.delmulin.com","petrolkorps.cc","dariox.club","mastodon.zapashcanon.fr","pouet.chapril.org","darknedgy.net","mastodon.orko.it","don.yasi2.com","penumbra.space","mi.underscore.world","flyovercountry.social","friendica.m14xa.ru","onewilshire.la","collapsitarian.io","social.mcjarbo.com","masto.otrared.es","steampunk.social","donphan.social","nixos.paris","majors.social","thesenate.cc","wokka.be","labyrinth.social","orz.uno","a.gawlinski.com","video.lemediatv.fr","halifaxsocial.ca","gensokyo.social","fedi.ruinouspowe.rs","desu.social","cryptocartel.social","pixel.nobigtech.es","anticom.world","mastodonmusic.social","tears.intherain.club","social.illegalpornography.com","toot.codatory.com","mkiii.amplifie.red","beef.moe","bollocks.social","academe.world","social.cryptography.dog","sasa.africa","pleroma.davidgtl.me","tentaclehead.games","kosmos.social","social.lemue.org","pixel.cocoate.com","malfunctional.net","neondemons.net","orbitalstation.one","es.shitposter.club","mastadon.bx23.net","social.bearveloper.dev","wzf.wtf","friends.wimmer-edv.de","pl.devfs.xyz","expired.mentality.rip","microblog.shivering-isles.com","bimmer.social","social.middleearth.fr","connectified.com","shpposter.club","bhre.social","futen.work","weeb.su","mastodon.nickmiller.dev","nekoland.fangluo.top","jkpg.rocks","floss.social","insoumis.social","friend.camp","mastodon.tedomum.net","ffflorian.social","mastodon.ehendershott.com","sarcasm.stream","peervideo.club","romancelandia.club","duckchat.me","uncontrollablegas.com","pleroma.envs.net","mastodon.cogindo.net","pao.moe","social.kuester7.com","ingsoc.email","btrfly.social","pleroma.pixp.cc","vorlon.space","mastodon.hr","bajax.us","mstdn.b-shock.org","drcassone.social","social.hutch.chat","m.dijy.eu.org","social.interru.io","volt.cafe","nymwars.org","social.edzilla.info","social.epicempower.com","framapiaf.org","spondr.cz","ika.queloud.net","nasface.cz","helladoge.com","mastodon.rosenberg-watt.com","hessen.social","don.rag.pub","ahhhhhh.social","mastouille.fr","pleroma.aspie.freemyip.com","mastodon.1984.cz","puppo.space","openbiblio.social","liberdon.com","m.geraffel.net","pleroma.manicphase.me","libcyb.so","social.bennypowers.dev","slowest.network","connos.ddnss.ch","fe.disroot.org","mk.phreedom.club","makerdon.org","broken.graphics","angrydome.au","ozhika.me","pl.seahorse.sh","c4.social","mastodon-relay.thedoodleproject.net","wikis.world","pony.social","grosshans.online","bidule.menf.in","motley.club","dotnet.social","fed.hvn.network","hackoon.com","cafe.chillout.chat","semiosen.de","pr.shc.kanagawa.jp","xerg.ga","oti.st","shadowverdon.info","queer.town","pl.slash.cl","deckard.pub","mastodon.mxhdr.net","hub.mancave.de","mk.odyssey346.dev","tum.social","ossum.net","boseburo.ddns.net","www.fediski.com","social.aero","pl.fossworld.hu","social.swagg.net","blabber.rocks","social.gemnoc.ca","mastodon.falktx.com","mastodon.tech","gall.family","kinky.business","mastodon.retr0.party","mstdn.rndmm.us","sneed.network","cyb3r.moe","theolddude.masto.host","relay.asonix.dog","iosdev.space","mastodon.lucci.xyz","unstraight.club","heylisten.social","talk.ahoxus.org","social.ghost7.com","ippandon.hopto.org","pforzelona.club","mstdn.social","sotong.cloud","mastodon-pa.sorbonne-universite.fr","wasatchfront.social","misskey.shinaaamo.com","nicecrew.digital","mstdn.asterism.xyz","japanties.org","fedi2.0x7f.one","social.076.ne.jp","m.rakyll.org","toot.gemma.ee","social.prometheus.systems","selfy.army","digitalcourage.social"]
0

